„	„	PUNCT	_	
Tervezési	tervezési	ADJ	Case=Nom|Degree=Pos|Number=Sing	
szerződés	szerződés	NOUN	Case=Nom|Number=Sing	
kiserőmű	kiserőmű	NOUN	Case=Nom|Number=Sing	
létesítésére	létesítés	NOUN	Case=Sub|Number=Sing|Number[psor]=Sing|Person[psor]=3	
vonatkozó	vonatkozó	ADJ	Case=Nom|Degree=Pos|Number=Sing|VerbForm=PartPres	
engedélyezési	engedélyezési	ADJ	Case=Nom|Degree=Pos|Number=Sing	
tervdokumentáció	tervdokumentáció	NOUN	Case=Nom|Number=Sing	
elkészítésére	elkészítés	NOUN	Case=Sub|Number=Sing|Number[psor]=Sing|Person[psor]=3	
"	"	PUNCT	_	
.	.	PUNCT	_	

A	a	DET	Definite=Def|PronType=Art	
tervezési	tervezési	ADJ	Case=Nom|Degree=Pos|Number=Sing	
feladat	feladat	NOUN	Case=Nom|Number=Sing	
rövid	rövid	ADJ	Case=Nom|Degree=Pos|Number=Sing	
ismertetése	ismertetés	NOUN	Case=Nom|Number=Sing|Number[psor]=Sing|Person[psor]=3	
:	:	PUNCT	_	
A	a	DET	Definite=Def|PronType=Art	
NHKV	NHKV	PROPN	Case=Nom|Number=Sing	
Zrt.	Zrt.	PROPN	Case=Nom|Number=Sing	
telephelyére	telephely	NOUN	Case=Sub|Number=Sing|Number[psor]=Sing|Person[psor]=3	
telepítendő	telepítendő	ADJ	Case=Nom|Degree=Pos|Number=Sing|VerbForm=PartFut	
0,5	0,5	NUM	Case=Nom|NumType=Frac|Number=Sing	
-	-	PUNCT	_	
3	3	NUM	Case=Nom|NumType=Card|Number=Sing	
MWe	MWe	PROPN	Case=Nom|Number=Sing	
névleges	névleges	ADJ	Case=Nom|Degree=Pos|Number=Sing	
villamos	villamos	NOUN	Case=Nom|Number=Sing	
,	,	PUNCT	_	
és	és	CONJ	_	
0,5	0,5	NUM	Case=Nom|NumType=Frac|Number=Sing	
-	-	PUNCT	_	
3	3	NUM	Case=Nom|NumType=Card|Number=Sing	
MWt	MWt	PROPN	Case=Nom|Number=Sing	
névleges	névleges	ADJ	Case=Nom|Degree=Pos|Number=Sing	
termikus	termikus	ADJ	Case=Nom|Degree=Pos|Number=Sing	
teljesítményű	teljesítményű	ADJ	Case=Nom|Degree=Pos|Number=Sing	
pirolízis	pirolízis	NOUN	Case=Nom|Number=Sing	
alapú	alapú	ADJ	Case=Nom|Degree=Pos|Number=Sing	
kapcsolt	kapcsolt	ADJ	Case=Nom|Degree=Pos|Number=Sing|VerbForm=PartPast	
energiatermelő	energiatermelő	ADJ	Case=Nom|Degree=Pos|Number=Sing	
egységek	egység	NOUN	Case=Nom|Number=Plur	
és	és	CONJ	_	
segédrendszereik	segédrendszer	NOUN	Case=Nom|Number=Plur|Number[psor]=Plur|Person[psor]=3	
,	,	PUNCT	_	
mint	mint	SCONJ	_	
sajátos	sajátos	ADJ	Case=Nom|Degree=Pos|Number=Sing	
energetikai	energetikai	ADJ	Case=Nom|Degree=Pos|Number=Sing	
létesítmények	létesítmény	NOUN	Case=Nom|Number=Plur	
létesítési	létesítési	ADJ	Case=Nom|Degree=Pos|Number=Sing	
engedélyezési	engedélyezési	ADJ	Case=Nom|Degree=Pos|Number=Sing	
tervezése	tervezés	NOUN	Case=Nom|Number=Sing|Number[psor]=Sing|Person[psor]=3	
,	,	PUNCT	_	
az	az	DET	Definite=Def|PronType=Art	
engedélyek	engedély	NOUN	Case=Nom|Number=Plur	
megszerzése	megszerzés	NOUN	Case=Nom|Number=Sing|Number[psor]=Sing|Person[psor]=3	
.	.	PUNCT	_	

