Megbízási	megbízási	ADJ	Case=Nom|Degree=Pos|Number=Sing	
szerződés	szerződés	NOUN	Case=Nom|Number=Sing	
a	a	DET	Definite=Def|PronType=Art	
„	„	PUNCT	_	
Mosoni-Duna	Mosoni-duna	NOUN	Case=Nom|Number=Sing	
torkolati	torkolati	ADJ	Case=Nom|Degree=Pos|Number=Sing	
szakaszának	szakasz	NOUN	Case=Gen|Number=Sing|Number[psor]=Sing|Person[psor]=3	
vízszint	vízszint	NOUN	Case=Nom|Number=Sing	
rehabilitációja	rehabilitáció	NOUN	Case=Nom|Number=Sing|Number[psor]=Sing|Person[psor]=3	
"	"	PUNCT	_	
című	című	ADJ	Case=Nom|Degree=Pos|Number=Sing	
,	,	PUNCT	_	
KEHOP-1	KEHOP-1	PROPN	Case=Nom|Number=Sing	
.	.	PUNCT	_	

3	3	NUM	Case=Nom|NumType=Card|Number=Sing	
.	.	PUNCT	_	
0-15-2016-00012	0-15-2016-00012	PROPN	Case=Nom|Number=Sing	
azonosító	azonosító	ADJ	Case=Nom|Degree=Pos|Number=Sing|VerbForm=PartPres	
számú	számú	ADJ	Case=Nom|Degree=Pos|Number=Sing	
projektben	projekt	NOUN	Case=Ine|Number=Sing	
tervezésre	tervezés	NOUN	Case=Sub|Number=Sing	
és	és	CONJ	_	
kivitelezésre	kivitelezés	NOUN	Case=Sub|Number=Sing	
FIDIC	FIDIC	PROPN	Case=Nom|Number=Sing	
Sárga	sárga	ADJ	Case=Nom|Degree=Pos|Number=Sing	
Könyv	könyv	NOUN	Case=Nom|Number=Sing	
szerint	szerint	ADP	_	
megkötésre	megkötés	NOUN	Case=Sub|Number=Sing	
kerülő	kerülő	ADJ	Case=Nom|Degree=Pos|Number=Sing|VerbForm=PartPres	
szerződésben	szerződés	NOUN	Case=Ine|Number=Sing	
foglalt	foglalt	ADJ	Case=Nom|Degree=Pos|Number=Sing|VerbForm=PartPast	
munkák	munka	NOUN	Case=Nom|Number=Plur	
FIDIC	FIDIC	PROPN	Case=Nom|Number=Sing	
mérnöki	mérnöki	ADJ	Case=Nom|Degree=Pos|Number=Sing	
,	,	PUNCT	_	
és	és	CONJ	_	
műszaki	műszaki	ADJ	Case=Nom|Degree=Pos|Number=Sing	
ellenőrzési	ellenőrzési	ADJ	Case=Nom|Degree=Pos|Number=Sing	
feladatainak	feladat	NOUN	Case=Gen|Number=Plur|Number[psor]=Sing|Person[psor]=3	
ellátása	ellátás	NOUN	Case=Nom|Number=Sing|Number[psor]=Sing|Person[psor]=3	
tárgyában	tárgy	NOUN	Case=Ine|Number=Sing|Number[psor]=Sing|Person[psor]=3	
.	.	PUNCT	_	

