Debrecen	Debrecen	PROPN	Case=Nom|Number=Sing	
város	város	NOUN	Case=Nom|Number=Sing	
útjainak	út	NOUN	Case=Gen|Number=Plur|Number[psor]=Sing|Person[psor]=3	
,	,	PUNCT	_	
egyes	egyes	ADJ	Case=Nom|Degree=Pos|Number=Sing	
járdáinak	járda	NOUN	Case=Gen|Number=Plur|Number[psor]=Sing|Person[psor]=3	
gépi	gépi	ADJ	Case=Nom|Degree=Pos|Number=Sing	
,	,	PUNCT	_	
kézi	kézi	ADJ	Case=Nom|Degree=Pos|Number=Sing	
úttisztítása	úttisztítás	NOUN	Case=Nom|Number=Sing|Number[psor]=Sing|Person[psor]=3	
,	,	PUNCT	_	
azok	az	PRON	Case=Nom|Number=Plur|Person=3|PronType=Dem	
téli	téli	ADJ	Case=Nom|Degree=Pos|Number=Sing	
síktalanítási	síktalanítási	ADJ	Case=Nom|Degree=Pos|Number=Sing	
és	és	CONJ	_	
hóeltakarítási	hóeltakarítási	ADJ	Case=Nom|Degree=Pos|Number=Sing	
munkái	munka	NOUN	Case=Nom|Number=Plur|Number[psor]=Sing|Person[psor]=3	
,	,	PUNCT	_	
valamint	valamint	CONJ	_	
az	az	DET	Definite=Def|PronType=Art	
illegális	illegális	ADJ	Case=Nom|Degree=Pos|Number=Sing	
szemétlerakóba	szemétlerakó	NOUN	Case=Ill|Number=Sing	
elhelyezett	elhelyezett	ADJ	Case=Nom|Degree=Pos|Number=Sing|VerbForm=PartPast	
hulladékok	hulladék	NOUN	Case=Nom|Number=Plur	
szeméttelepre	szeméttelep	NOUN	Case=Sub|Number=Sing	
való	való	ADJ	Case=Nom|Degree=Pos|Number=Sing|VerbForm=PartPres	
szállítási	szállítási	ADJ	Case=Nom|Degree=Pos|Number=Sing	
munkái	munka	NOUN	Case=Nom|Number=Plur|Number[psor]=Sing|Person[psor]=3	
.	.	PUNCT	_	

Vállalkozási	Vállalkozási	PROPN	Case=Nom|Number=Sing	
szerződés	szerződés	NOUN	Case=Nom|Number=Sing	
.	.	PUNCT	_	

