Vállalkozási	Vállalkozási	PROPN	Case=Nom|Number=Sing	
szerződés	szerződés	NOUN	Case=Nom|Number=Sing	
a	a	DET	Definite=Def|PronType=Art	
Budapest	Budapest	PROPN	Case=Nom|Number=Sing	
Főváros	főváros	NOUN	Case=Nom|Number=Sing	
XIII	13	NUM	Case=Nom|NumType=Card|Number=Sing	
.	.	PUNCT	_	

Kerületi	Kerületi	PROPN	Case=Nom|Number=Sing	
Önkormányzat	Önkormányzat	PROPN	Case=Nom|Number=Sing	
Prevenciós	prevenciós	ADJ	Case=Nom|Degree=Pos|Number=Sing	
Központ	Központ	PROPN	Case=Nom|Number=Sing	
és	és	CONJ	_	
Családi	családi	ADJ	Case=Nom|Degree=Pos|Number=Sing	
Bölcsődei	bölcsődei	ADJ	Case=Nom|Degree=Pos|Number=Sing	
Hálózat	Hálózat	PROPN	Case=Nom|Number=Sing	
telephelyei	telephely	NOUN	Case=Nom|Number=Plur|Number[psor]=Sing|Person[psor]=3	
részére	részére	ADP	_	
ételkészítési	ételkészítési	ADJ	Case=Nom|Degree=Pos|Number=Sing	
és	és	CONJ	_	
szállítási	szállítási	ADJ	Case=Nom|Degree=Pos|Number=Sing	
szolgáltatás	szolgáltatás	NOUN	Case=Nom|Number=Sing	
biztosítása	biztosítás	NOUN	Case=Nom|Number=Sing|Number[psor]=Sing|Person[psor]=3	
,	,	PUNCT	_	
12	12	NUM	Case=Nom|NumType=Card|Number=Sing	
+	+	PUNCT	_	
24	24	NUM	Case=Nom|NumType=Card|Number=Sing	
hónapos	hónapos	ADJ	Case=Nom|Degree=Pos|Number=Sing	
határozott	határozott	ADJ	Case=Nom|Degree=Pos|Number=Sing	
időtartamra	időtartam	NOUN	Case=Sub|Number=Sing	

