Vállalkozási	Vállalkozási	PROPN	Case=Nom|Number=Sing	
szerződés	szerződés	NOUN	Case=Nom|Number=Sing	
keretében	keret	NOUN	Case=Ine|Number=Sing|Number[psor]=Sing|Person[psor]=3	
a	a	DET	Definite=Def|PronType=Art	
Fővárosi	Fővárosi	PROPN	Case=Nom|Number=Sing	
Csatornázási	csatornázási	ADJ	Case=Nom|Degree=Pos|Number=Sing	
Művek	Művek	PROPN	Case=Nom|Number=Sing	
Zrt.	Zrt.	PROPN	Case=Nom|Number=Sing	
Kerepesi	Kerepesi	PROPN	Case=Nom|Number=Sing	
út	út	PROPN	Case=Nom|Number=Sing	
19-21	19-21	NUM	Case=Nom|NumType[sem]=Result|Number=Sing	
.	.	PUNCT	_	
szám	szám	NOUN	Case=Nom|Number=Sing	
alatti	alatti	ADJ	Case=Nom|Degree=Pos|Number=Sing	
telephelyén	telephely	NOUN	Case=Sup|Number=Sing|Number[psor]=Sing|Person[psor]=3	
szennyvízkivételi	szennyvízkivételi	ADJ	Case=Nom|Degree=Pos|Number=Sing	
mű	mű	NOUN	Case=Nom|Number=Sing	
és	és	CONJ	_	
szennyvízhőt	szennyvízhő	NOUN	Case=Acc|Number=Sing	
hasznosító	hasznosító	ADJ	Case=Nom|Degree=Pos|Number=Sing|VerbForm=PartPres	
hőszivattyú	hőszivattyú	NOUN	Case=Nom|Number=Sing	
gépház	gépház	NOUN	Case=Nom|Number=Sing	
üzemeltetése	üzemeltetés	NOUN	Case=Nom|Number=Sing|Number[psor]=Sing|Person[psor]=3	
.	.	PUNCT	_	

