Vállalkozási	Vállalkozási	PROPN	Case=Nom|Number=Sing	
szerződés	szerződés	NOUN	Case=Nom|Number=Sing	
keretében	keret	NOUN	Case=Ine|Number=Sing|Number[psor]=Sing|Person[psor]=3	
a	a	DET	Definite=Def|PronType=Art	
Magyar	Magyar	PROPN	Case=Nom|Number=Sing	
Nemzeti	Nemzeti	PROPN	Case=Nom|Number=Sing	
Bank	Bank	PROPN	Case=Nom|Number=Sing	
épületeiben	épület	NOUN	Case=Ine|Number=Plur|Number[psor]=Sing|Person[psor]=3	
meglévő	meglévő	ADJ	Case=Nom|Degree=Pos|Number=Sing|VerbForm=PartPres	
stúdió	stúdió	NOUN	Case=Nom|Number=Sing	
-	-	PUNCT	_	
,	,	PUNCT	_	
vetítés	vetítés	NOUN	Case=Nom|Number=Sing	
-	-	PUNCT	_	
és	és	CONJ	_	
hangtechnikai	hangtechnikai	ADJ	Case=Nom|Degree=Pos|Number=Sing	
berendezések	berendezés	NOUN	Case=Nom|Number=Plur	
rendszeres	rendszeres	ADJ	Case=Nom|Degree=Pos|Number=Sing	
karbantartási	karbantartási	ADJ	Case=Nom|Degree=Pos|Number=Sing	
feladatainak	feladat	NOUN	Case=Gen|Number=Plur|Number[psor]=Sing|Person[psor]=3	
elvégzése	elvégzés	NOUN	Case=Nom|Number=Sing|Number[psor]=Sing|Person[psor]=3	
,	,	PUNCT	_	
a	a	DET	Definite=Def|PronType=Art	
felmerülő	felmerülő	ADJ	Case=Nom|Degree=Pos|Number=Sing|VerbForm=PartPres	
javítási	javítási	ADJ	Case=Nom|Degree=Pos|Number=Sing	
munkák	munka	NOUN	Case=Nom|Number=Plur	
,	,	PUNCT	_	
pótló	pótló	ADJ	Case=Nom|Degree=Pos|Number=Sing|VerbForm=PartPres	
beruházások	beruházás	NOUN	Case=Nom|Number=Plur	
előkészítése	előkészítés	NOUN	Case=Nom|Number=Sing|Number[psor]=Sing|Person[psor]=3	
és	és	CONJ	_	
végrehajtása	végrehajtás	NOUN	Case=Nom|Number=Sing|Number[psor]=Sing|Person[psor]=3	
,	,	PUNCT	_	
munkanapokon	munkanap	NOUN	Case=Sup|Number=Plur	
munkaidőben	munkaidő	NOUN	Case=Ine|Number=Sing	
a	a	DET	Definite=Def|PronType=Art	
Székházban	székház	NOUN	Case=Ine|Number=Sing	
hangtechnikus	hangtechnikus	NOUN	Case=Nom|Number=Sing	
szakfelügyelet	szakfelügyelet	NOUN	Case=Nom|Number=Sing	
biztosítása	biztosítás	NOUN	Case=Nom|Number=Sing|Number[psor]=Sing|Person[psor]=3	
,	,	PUNCT	_	
továbbá	továbbá	ADV	_	
az	az	DET	Definite=Def|PronType=Art	
MNB	MNB	PROPN	Case=Nom|Number=Sing	
rendezvényein	rendezvény	NOUN	Case=Sup|Number=Plur|Number[psor]=Sing|Person[psor]=3	
való	való	ADJ	Case=Nom|Degree=Pos|Number=Sing|VerbForm=PartPres	
közreműködés	közreműködés	NOUN	Case=Nom|Number=Sing	
.	.	PUNCT	_	

