A	a	DET	Definite=Def|PronType=Art	
Fővárosi	Fővárosi	PROPN	Case=Nom|Number=Sing	
Vízművek	vízmű	NOUN	Case=Nom|Number=Plur	
Zrt.	Zrt.	PROPN	Case=Nom|Number=Sing	
csoportos	csoportos	ADJ	Case=Nom|Degree=Pos|Number=Sing	
biztosítási	biztosítási	ADJ	Case=Nom|Degree=Pos|Number=Sing	
szerződést	szerződés	NOUN	Case=Acc|Number=Sing	
kíván	kíván	VERB	Definite=Ind|Mood=Ind|Number=Sing|Person=3|Tense=Pres|VerbForm=Fin|Voice=Act	
kötni	köt	VERB	VerbForm=Inf|Voice=Act	
azon	azon	PRON	Case=Nom|Number=Sing|Person=3|PronType=Dem	
lakossági	lakossági	ADJ	Case=Nom|Degree=Pos|Number=Sing	
és	és	CONJ	_	
közületi	közületi	ADJ	Case=Nom|Degree=Pos|Number=Sing	
fogyasztói	fogyasztói	ADJ	Case=Nom|Degree=Pos|Number=Sing	
javára	jó	NOUN	Case=Sub|Number=Sing|Number[psor]=Sing|Person[psor]=3	
,	,	PUNCT	_	
akik	aki	PRON	Case=Nom|Number=Plur|Person=3|PronType=Rel	
a	a	DET	Definite=Def|PronType=Art	
csoportos	csoportos	ADJ	Case=Nom|Degree=Pos|Number=Sing	
biztosításhoz	biztosítás	NOUN	Case=All|Number=Sing	
biztosítottként	biztosított	ADJ	Case=Abs|Degree=Pos|Number=Sing	
csatlakozni	csatlakozik	VERB	VerbForm=Inf|Voice=Act	
kívánnak	kíván	VERB	Definite=Ind|Mood=Ind|Number=Plur|Person=3|Tense=Pres|VerbForm=Fin|Voice=Act	
.	.	PUNCT	_	

A	a	DET	Definite=Def|PronType=Art	
csoportos	csoportos	ADJ	Case=Nom|Degree=Pos|Number=Sing	
biztosítás	biztosítás	NOUN	Case=Nom|Number=Sing	
a	a	DET	Definite=Def|PronType=Art	
következő	következő	ADJ	Case=Nom|Degree=Pos|Number=Sing|VerbForm=PartPres	
események	esemény	NOUN	Case=Nom|Number=Plur	
bekövetkeztére	bekövetkezte	NOUN	Case=Sub|Number=Sing	
nyújtana	nyújt	VERB	Definite=Ind|Mood=Cnd|Number=Sing|Person=3|Tense=Pres|VerbForm=Fin|Voice=Act	
fedezetet	fedezet	NOUN	Case=Acc|Number=Sing	
:	:	PUNCT	_	
-	-	PUNCT	_	
keresőképtelenség	keresőképtelenség	NOUN	Case=Nom|Number=Sing	
esetén	eset	NOUN	Case=Sup|Number=Sing|Number[psor]=Sing|Person[psor]=3	
,	,	PUNCT	_	
-	-	PUNCT	_	
munkanélküliség	munkanélküliség	NOUN	Case=Nom|Number=Sing	
esetén	eset	NOUN	Case=Sup|Number=Sing|Number[psor]=Sing|Person[psor]=3	
,	,	PUNCT	_	
-	-	PUNCT	_	
vízelfolyás	vízelfolyás	NOUN	Case=Nom|Number=Sing	
esetén	eset	NOUN	Case=Sup|Number=Sing|Number[psor]=Sing|Person[psor]=3	
(	(	PUNCT	_	
kizárólag	kizárólag	ADV	_	
az	az	DET	Definite=Def|PronType=Art	
elfolyt	elfolyik	VERB	Definite=Ind|Mood=Ind|Number=Sing|Person=3|Tense=Past|VerbForm=Fin|Voice=Act	
víz	víz	NOUN	Case=Nom|Number=Sing	
értékére	érték	NOUN	Case=Sub|Number=Sing|Number[psor]=Sing|Person[psor]=3	
és	és	CONJ	_	
azon	az	PRON	Case=Sup|Number=Sing|Person=3|PronType=Dem	
belül	belül	ADP	_	
is	is	CONJ	_	
kizárólag	kizárólag	ADV	_	
arra	az	PRON	Case=Sub|Number=Sing|Person=3|PronType=Dem	
a	a	DET	Definite=Def|PronType=Art	
mennyiségre	mennyiség	NOUN	Case=Sub|Number=Sing	
,	,	PUNCT	_	
amire	ami	PRON	Case=Sub|Number=Sing|Person=3|PronType=Rel	
az	az	DET	Definite=Def|PronType=Art	
Fővárosi	Fővárosi	PROPN	Case=Nom|Number=Sing	
Vízművek	vízmű	NOUN	Case=Nom|Number=Plur	
Zrt.	Zrt.	PROPN	Case=Nom|Number=Sing	
nem	nem	ADV	PronType=Neg	
térít	térít	VERB	Definite=Ind|Mood=Ind|Number=Sing|Person=3|Tense=Pres|VerbForm=Fin|Voice=Act	
)	)	PUNCT	_	
.	.	PUNCT	_	

A	a	DET	Definite=Def|PronType=Art	
„	„	PUNCT	_	
Cseppnyi	cseppnyi	ADJ	Case=Nom|Degree=Pos|Number=Sing	
biztonság	biztonság	NOUN	Case=Nom|Number=Sing	
"	"	PUNCT	_	
elnevezés	elnevezés	NOUN	Case=Nom|Number=Sing	
a	a	DET	Definite=Def|PronType=Art	
szolgáltatás	szolgáltatás	NOUN	Case=Nom|Number=Sing	
projekt	projekt	NOUN	Case=Nom|Number=Sing	
neve	név	NOUN	Case=Nom|Number=Sing|Number[psor]=Sing|Person[psor]=3	
,	,	PUNCT	_	
a	a	DET	Definite=Def|PronType=Art	
piacra	piac	NOUN	Case=Sub|Number=Sing	
vezetés	vezetés	NOUN	Case=Nom|Number=Sing	
más	más	PRON	Case=Nom|Number=Sing|Person=3|PronType=Ind	
fantázianévvel	fantázianév	NOUN	Case=Ins|Number=Sing	
történik	történik	VERB	Definite=Ind|Mood=Ind|Number=Sing|Person=3|Tense=Pres|VerbForm=Fin|Voice=Act	
.	.	PUNCT	_	

A	a	DET	Definite=Def|PronType=Art	
beszerzés	beszerzés	NOUN	Case=Nom|Number=Sing	
célja	cél	NOUN	Case=Nom|Number=Sing|Number[psor]=Sing|Person[psor]=3	
,	,	PUNCT	_	
hogy	hogy	SCONJ	_	
a	a	DET	Definite=Def|PronType=Art	
Fővárosi	Fővárosi	PROPN	Case=Nom|Number=Sing	
Vízművek	vízmű	NOUN	Case=Nom|Number=Plur	
Zrt.	Zrt.	PROPN	Case=Nom|Number=Sing	
a	a	DET	Definite=Def|PronType=Art	
közbeszerzési	közbeszerzési	ADJ	Case=Nom|Degree=Pos|Number=Sing	
eljárás	eljárás	NOUN	Case=Nom|Number=Sing	
során	sor	NOUN	Case=Sup|Number=Sing|Number[psor]=Sing|Person[psor]=3	
nyertes	nyertes	ADJ	Case=Nom|Degree=Pos|Number=Sing	
biztosító	biztosító	ADJ	Case=Nom|Degree=Pos|Number=Sing|VerbForm=PartPres	
társasággal	társaság	NOUN	Case=Ins|Number=Sing	
a	a	DET	Definite=Def|PronType=Art	
közbeszerzési	közbeszerzési	ADJ	Case=Nom|Degree=Pos|Number=Sing	
eljárást	eljárás	NOUN	Case=Acc|Number=Sing	
követően	követő	ADJ	Case=Ess|Degree=Pos|Number=Sing|VerbForm=PartPres	
létrehozzon	létrehoz	VERB	Definite=Ind|Mood=Imp|Number=Sing|Person=3|Tense=Pres|VerbForm=Fin|Voice=Act	
egy	egy	DET	Definite=Ind|PronType=Art	
biztosítási	biztosítási	ADJ	Case=Nom|Degree=Pos|Number=Sing	
terméket	termék	NOUN	Case=Acc|Number=Sing	
.	.	PUNCT	_	

A	a	DET	Definite=Def|PronType=Art	
konstrukcióban	konstrukció	NOUN	Case=Ine|Number=Sing	
külön	külön	ADJ	Case=Nom|Degree=Pos|Number=Sing	
csomag	csomag	NOUN	Case=Nom|Number=Sing	
kerül	kerül	VERB	Definite=Ind|Mood=Ind|Number=Sing|Person=3|Tense=Pres|VerbForm=Fin|Voice=Act	
kialakításra	kialakítás	NOUN	Case=Sub|Number=Sing	
a	a	DET	Definite=Def|PronType=Art	
nem	nem	ADV	PronType=Neg	
természetes	természetes	ADJ	Case=Nom|Degree=Pos|Number=Sing	
személy	személy	NOUN	Case=Nom|Number=Sing	
fogyasztókra	fogyasztó	NOUN	Case=Sub|Number=Plur	
vonatkozóan	vonatkozó	ADJ	Case=Ess|Degree=Pos|Number=Sing|VerbForm=PartPres	
,	,	PUNCT	_	
mely	mely	PRON	Case=Nom|Number=Sing|Person=3|PronType=Rel	
csomag	csomag	NOUN	Case=Nom|Number=Sing	
kizárólag	kizárólag	ADV	_	
vízelfolyásra	vízelfolyás	NOUN	Case=Sub|Number=Sing	
térít	térít	VERB	Definite=Ind|Mood=Ind|Number=Sing|Person=3|Tense=Pres|VerbForm=Fin|Voice=Act	
.	.	PUNCT	_	

