A	a	DET	Definite=Def|PronType=Art	
Pécsi	Pécsi	PROPN	Case=Nom|Number=Sing	
Tudományegyetem	Tudományegyetem	PROPN	Case=Nom|Number=Sing	
részére	részére	ADP	_	
megvalósítandó	megvalósítandó	ADJ	Case=Nom|Degree=Pos|Number=Sing|VerbForm=PartFut	
szolgáltatásra	szolgáltatás	NOUN	Case=Sub|Number=Sing	
irányuló	irányuló	ADJ	Case=Nom|Degree=Pos|Number=Sing|VerbForm=PartPres	
megbízási	megbízási	ADJ	Case=Nom|Degree=Pos|Number=Sing	
keretmegállapodás	keretmegállapodás	NOUN	Case=Nom|Number=Sing	
,	,	PUNCT	_	
és	és	CONJ	_	
megbízási	megbízási	ADJ	Case=Nom|Degree=Pos|Number=Sing	
szerződések	szerződés	NOUN	Case=Nom|Number=Plur	
audit	audit	NOUN	Case=Nom|Number=Sing	
tevékenység	tevékenység	NOUN	Case=Nom|Number=Sing	
folytatására	folytatás	NOUN	Case=Sub|Number=Sing|Number[psor]=Sing|Person[psor]=3	
,	,	PUNCT	_	
melynek	mely	PRON	Case=Gen|Number=Sing|Person=3|PronType=Rel	
tárgya	tárgy	NOUN	Case=Nom|Number=Sing|Number[psor]=Sing|Person[psor]=3	
:	:	PUNCT	_	
a	a	DET	Definite=Def|PronType=Art	
2014.,	2014.,	PROPN	Case=Nom|Number=Sing	

2015.,	2015.,	PROPN	Case=Nom|Number=Sing	

2016.,	2016.,	PROPN	Case=Nom|Number=Sing	

2017.	2017.	ADJ	Case=Nom|NumType=Ord|Number=Sing	
évi	évi	ADJ	Case=Nom|Degree=Pos|Number=Sing	
elemi	elemi	ADJ	Case=Nom|Degree=Pos|Number=Sing	
költségvetési	költségvetési	ADJ	Case=Nom|Degree=Pos|Number=Sing	
beszámoló	beszámoló	NOUN	Case=Nom|Number=Sing	
,	,	PUNCT	_	
valamint	valamint	CONJ	_	
a	a	DET	Definite=Def|PronType=Art	
szerződés	szerződés	NOUN	Case=Nom|Number=Sing	
megkötésétől	megkötés	NOUN	Case=Abl|Number=Sing|Number[psor]=Sing|Person[psor]=3	
számított	számított	ADJ	Case=Nom|Degree=Pos|Number=Sing|VerbForm=PartPast	
48	48	NUM	Case=Nom|NumType=Card|Number=Sing	
hónap	hónap	NOUN	Case=Nom|Number=Sing	
alatt	alatt	ADP	_	
auditköteles	auditköteles	ADJ	Case=Nom|Degree=Pos|Number=Sing	
pályázatok	pályázat	NOUN	Case=Nom|Number=Plur	
kapcsán	kapcsán	ADP	_	
felmerülő	felmerülő	ADJ	Case=Nom|Degree=Pos|Number=Sing|VerbForm=PartPres	
könyvvizsgálati	könyvvizsgálati	ADJ	Case=Nom|Degree=Pos|Number=Sing	
szolgáltatás	szolgáltatás	NOUN	Case=Nom|Number=Sing	
.	.	PUNCT	_	

