Kereskedelmi	Kereskedelmi	PROPN	Case=Nom|Number=Sing	
(	(	PUNCT	_	
szállítási	szállítási	ADJ	Case=Nom|Degree=Pos|Number=Sing	
)	)	PUNCT	_	
szerződés	szerződés	NOUN	Case=Nom|Number=Sing	
:	:	PUNCT	_	
Budapest	Budapest	PROPN	Case=Nom|Number=Sing	
Főváros	főváros	NOUN	Case=Nom|Number=Sing	
XII	12	NUM	Case=Nom|NumType=Card|Number=Sing	
.	.	PUNCT	_	
kerület	kerület	NOUN	Case=Nom|Number=Sing	
Hegyvidéki	hegyvidéki	ADJ	Case=Nom|Degree=Pos|Number=Sing	
Önkormányzat	Önkormányzat	PROPN	Case=Nom|Number=Sing	
és	és	CONJ	_	
egyes	egyes	ADJ	Case=Nom|Degree=Pos|Number=Sing	
intézményeinek	intézmény	NOUN	Case=Gen|Number=Plur|Number[psor]=Sing|Person[psor]=3	
földgáz-energia	földgáz-energia	NOUN	Case=Nom|Number=Sing	
versenypiaci	versenypiaci	ADJ	Case=Nom|Degree=Pos|Number=Sing	
beszerzésére	beszerzés	NOUN	Case=Sub|Number=Sing|Number[psor]=Sing|Person[psor]=3	
.	.	PUNCT	_	

