Adásvételi	adásvételi	ADJ	Case=Nom|Degree=Pos|Number=Sing	
szerződés	szerződés	NOUN	Case=Nom|Number=Sing	
két	két	NUM	Case=Nom|NumType=Card|Number=Sing	
évben	év	NOUN	Case=Ine|Number=Sing	
szükséges	szükséges	ADJ	Case=Nom|Degree=Pos|Number=Sing	
különböző	különböző	ADJ	Case=Nom|Degree=Pos|Number=Sing	
szemlencsék	szemlencse	NOUN	Case=Nom|Number=Plur	
és	és	CONJ	_	
a	a	DET	Definite=Def|PronType=Art	
beültetésükhöz	beültetés	NOUN	Case=All|Number=Sing|Number[psor]=Plur|Person[psor]=3	
szükséges	szükséges	ADJ	Case=Nom|Degree=Pos|Number=Sing	
eszközök	eszköz	NOUN	Case=Nom|Number=Plur	
beszerzésére	beszerzés	NOUN	Case=Sub|Number=Sing|Number[psor]=Sing|Person[psor]=3	
a	a	DET	Definite=Def|PronType=Art	
Szent	Szent	PROPN	Case=Nom|Number=Sing	
Lázár	Lázár	PROPN	Case=Nom|Number=Sing	
Megyei	Megyei	PROPN	Case=Nom|Number=Sing	
Kórházban	Kórház	PROPN	Case=Ine|Number=Sing	
kihelyezett	kihelyezett	ADJ	Case=Nom|Degree=Pos|Number=Sing|VerbForm=PartPast	
áruraktár	áruraktár	NOUN	Case=Nom|Number=Sing	
biztosításával	biztosítás	NOUN	Case=Ins|Number=Sing|Number[psor]=Sing|Person[psor]=3	
.	.	PUNCT	_	

