Adásvételi	adásvételi	ADJ	Case=Nom|Degree=Pos|Number=Sing	
szerződés	szerződés	NOUN	Case=Nom|Number=Sing	
a	a	DET	Definite=Def|PronType=Art	
veleszületett	veleszületett	ADJ	Case=Nom|Degree=Pos|Number=Sing|VerbForm=PartPast	
vérzékenység	vérzékenység	NOUN	Case=Nom|Number=Sing	
kezelésére	kezelés	NOUN	Case=Sub|Number=Sing|Number[psor]=Sing|Person[psor]=3	
szolgáló	szolgáló	ADJ	Case=Nom|Degree=Pos|Number=Sing|VerbForm=PartPres	
nagy	nagy	ADJ	Case=Nom|Degree=Pos|Number=Sing	
von	von	PROPN	Case=Nom|Number=Sing	
Willebrand	willebrand	NOUN	Case=Nom|Number=Sing	
faktor	faktor	NOUN	Case=Nom|Number=Sing	
tartalmú	tartalmú	ADJ	Case=Nom|Degree=Pos|Number=Sing	
nagytisztaságú	nagytisztaságú	ADJ	Case=Nom|Degree=Pos|Number=Sing	
,	,	PUNCT	_	
plazma	plazma	NOUN	Case=Nom|Number=Sing	
eredetű	eredetű	ADJ	Case=Nom|Degree=Pos|Number=Sing	
VIII	8	NUM	Case=Nom|NumType=Card|Number=Sing	
.	.	PUNCT	_	
faktor	faktor	NOUN	Case=Nom|Number=Sing	
koncentrátum	koncentrátum	NOUN	Case=Nom|Number=Sing	
,	,	PUNCT	_	
amely	amely	PRON	Case=Nom|Number=Sing|Person=3|PronType=Rel	
mérsékelt	mérsékelt	ADJ	Case=Nom|Degree=Pos|Number=Sing	
súlyosságú	súlyosságú	ADJ	Case=Nom|Degree=Pos|Number=Sing	
von	von	PROPN	Case=Nom|Number=Sing	
Willebrand	willebrand	NOUN	Case=Nom|Number=Sing	
betegség	betegség	NOUN	Case=Nom|Number=Sing	
,	,	PUNCT	_	
haemophilia	haemophilia	NOUN	Case=Nom|Number=Sing	
A	a	DET	Definite=Def|PronType=Art	
,	,	PUNCT	_	
immuntolerancia	immuntolerancia	NOUN	Case=Nom|Number=Sing	
indukciós	indukciós	ADJ	Case=Nom|Degree=Pos|Number=Sing	
kezelésére	kezelés	NOUN	Case=Sub|Number=Sing|Number[psor]=Sing|Person[psor]=3	
alkalmas	alkalmas	ADJ	Case=Nom|Degree=Pos|Number=Sing	
(	(	PUNCT	_	
ATC	ATC	PROPN	Case=Nom|Number=Sing	
kód	kód	NOUN	Case=Nom|Number=Sing	
:	:	PUNCT	_	
B02BD06	B02BD06	PROPN	Case=Nom|Number=Sing	
)	)	PUNCT	_	
készítmény	készítmény	NOUN	Case=Nom|Number=Sing	
2016.	2016.	ADJ	Case=Nom|NumType=Ord|Number=Sing	
évi	évi	ADJ	Case=Nom|Degree=Pos|Number=Sing	
beszerzése	beszerzés	NOUN	Case=Nom|Number=Sing|Number[psor]=Sing|Person[psor]=3	
tárgyában	tárgy	NOUN	Case=Ine|Number=Sing|Number[psor]=Sing|Person[psor]=3	
.	.	PUNCT	_	

