Vállalkozási	Vállalkozási	PROPN	Case=Nom|Number=Sing	
keretszerződés	keretszerződés	NOUN	Case=Nom|Number=Sing	
Budapest	Budapest	PROPN	Case=Nom|Number=Sing	
közigazgatási	közigazgatási	ADJ	Case=Nom|Degree=Pos|Number=Sing	
területén	terület	NOUN	Case=Sup|Number=Sing|Number[psor]=Sing|Person[psor]=3	
belül	belül	ADP	_	
a	a	DET	Definite=Def|PronType=Art	
Főkert	főkert	NOUN	Case=Nom|Number=Sing	
Nonprofit	nonprofit	ADJ	Case=Nom|Degree=Pos|Number=Sing	
Zrt.	Zrt.	PROPN	Case=Nom|Number=Sing	
által	által	ADP	_	
fenntartott	fenntartott	ADJ	Case=Nom|Degree=Pos|Number=Sing|VerbForm=PartPast	
kiemelt	kiemelt	ADJ	Case=Nom|Degree=Pos|Number=Sing|VerbForm=PartPast	
közcélú	közcélú	ADJ	Case=Nom|Degree=Pos|Number=Sing	
zöldterületek	zöldterület	NOUN	Case=Nom|Number=Plur	
,	,	PUNCT	_	
közparkok	közpark	NOUN	Case=Nom|Number=Plur	
és	és	CONJ	_	
fasorok	fasor	NOUN	Case=Nom|Number=Plur	
területén	terület	NOUN	Case=Sup|Number=Sing|Number[psor]=Sing|Person[psor]=3	
lévő	lévő	ADJ	Case=Nom|Degree=Pos|Number=Sing|VerbForm=PartPres	
fák	fa	NOUN	Case=Nom|Number=Plur	
koronáinak	korona	NOUN	Case=Gen|Number=Plur|Number[psor]=Sing|Person[psor]=3	
gallyazási	gallyazási	ADJ	Case=Nom|Degree=Pos|Number=Sing	
,	,	PUNCT	_	
fa	fa	NOUN	Case=Nom|Number=Sing	
visszavágási	visszavágási	ADJ	Case=Nom|Degree=Pos|Number=Sing	
,	,	PUNCT	_	
száraz	száraz	ADJ	Case=Nom|Degree=Pos|Number=Sing	
fák	fa	NOUN	Case=Nom|Number=Plur	
kivágási	kivágási	ADJ	Case=Nom|Degree=Pos|Number=Sing	
munkái	munka	NOUN	Case=Nom|Number=Plur|Number[psor]=Sing|Person[psor]=3	
és	és	CONJ	_	
faültetési	faültetési	ADJ	Case=Nom|Degree=Pos|Number=Sing	
munkák	munka	NOUN	Case=Nom|Number=Plur	
,	,	PUNCT	_	
a	a	DET	Definite=Def|PronType=Art	
műszaki	műszaki	ADJ	Case=Nom|Degree=Pos|Number=Sing	
leírásban	leírás	NOUN	Case=Ine|Number=Sing	
meghatározott	meghatározott	ADJ	Case=Nom|Degree=Pos|Number=Sing|VerbForm=PartPast	
követelmények	követelmény	NOUN	Case=Nom|Number=Plur	
szerint	szerint	ADP	_	
.	.	PUNCT	_	

