Bérlettel	bérlet	NOUN	Case=Ins|Number=Sing	
vegyes	vegyes	ADJ	Case=Nom|Degree=Pos|Number=Sing	
vállalkozási	vállalkozási	ADJ	Case=Nom|Degree=Pos|Number=Sing	
szerződés	szerződés	NOUN	Case=Nom|Number=Sing	
keretében	keret	NOUN	Case=Ine|Number=Sing|Number[psor]=Sing|Person[psor]=3	
teljes	teljes	ADJ	Case=Nom|Degree=Pos|Number=Sing	
körű	körű	ADJ	Case=Nom|Degree=Pos|Number=Sing	
élelmezési	élelmezési	ADJ	Case=Nom|Degree=Pos|Number=Sing	
szolgáltatás	szolgáltatás	NOUN	Case=Nom|Number=Sing	
biztosítása	biztosítás	NOUN	Case=Nom|Number=Sing|Number[psor]=Sing|Person[psor]=3	
,	,	PUNCT	_	
dietetikai	dietetikai	ADJ	Case=Nom|Degree=Pos|Number=Sing	
szolgálat	szolgálat	NOUN	Case=Nom|Number=Sing	
ellátásával	ellátás	NOUN	Case=Ins|Number=Sing|Number[psor]=Sing|Person[psor]=3	
a	a	DET	Definite=Def|PronType=Art	
Markusovszky	markusovszky	NOUN	Case=Nom|Number=Sing	
Egyetemi	egyetemi	ADJ	Case=Nom|Degree=Pos|Number=Sing	
Oktatókórház	oktatókórház	NOUN	Case=Nom|Number=Sing	
részére	részére	ADP	_	
,	,	PUNCT	_	
amely	amely	PRON	Case=Nom|Number=Sing|Person=3|PronType=Rel	
magában	maga	PRON	Case=Ine|Number=Sing|Person=3|Reflex=Yes	
foglalja	foglal	VERB	Definite=Def|Mood=Ind|Number=Sing|Person=3|Tense=Pres|VerbForm=Fin|Voice=Act	
a	a	DET	Definite=Def|PronType=Art	
fekvőbetegek	fekvőbeteg	NOUN	Case=Nom|Number=Plur	
élelmezését	élelmezés	NOUN	Case=Acc|Number=Sing|Number[psor]=Sing|Person[psor]=3	
(	(	PUNCT	_	
1511	1511	NUM	Case=Nom|NumType=Card|Number=Sing	
-	-	PUNCT	_	
952	952	NUM	Case=Nom|NumType=Card|Number=Sing	
aktív	aktív	ADJ	Case=Nom|Degree=Pos|Number=Sing	
és	és	CONJ	_	
559	559	NUM	Case=Nom|NumType=Card|Number=Sing	
krónikus	krónikus	ADJ	Case=Nom|Degree=Pos|Number=Sing	
-	-	PUNCT	_	
ágyas	ágyas	ADJ	Case=Nom|Degree=Pos|Number=Sing	
intézmény	intézmény	NOUN	Case=Nom|Number=Sing	
változó	változó	ADJ	Case=Nom|Degree=Pos|Number=Sing|VerbForm=PartPres	
napi	napi	ADJ	Case=Nom|Degree=Pos|Number=Sing	
létszámban	létszám	NOUN	Case=Ine|Number=Sing	
,	,	PUNCT	_	
az	az	DET	Definite=Def|PronType=Art	
éves	éves	ADJ	Case=Nom|Degree=Pos|Number=Sing	
betegélelmezési	betegélelmezési	ADJ	Case=Nom|Degree=Pos|Number=Sing	
napok	nap	NOUN	Case=Nom|Number=Plur	
száma	szám	NOUN	Case=Nom|Number=Sing|Number[psor]=Sing|Person[psor]=3	
309	309	NUM	Case=Nom|NumType=Card|Number=Sing	
600.	600.	ADJ	Case=Nom|NumType=Ord|Number=Sing	

Az	az	DET	Definite=Def|PronType=Art	
élelmezési	élelmezési	ADJ	Case=Nom|Degree=Pos|Number=Sing	
szolgáltatás	szolgáltatás	NOUN	Case=Nom|Number=Sing	
magában	maga	PRON	Case=Ine|Number=Sing|Person=3|Reflex=Yes	
foglalja	foglal	VERB	Definite=Def|Mood=Ind|Number=Sing|Person=3|Tense=Pres|VerbForm=Fin|Voice=Act	
a	a	DET	Definite=Def|PronType=Art	
kapcsolódó	kapcsolódó	ADJ	Case=Nom|Degree=Pos|Number=Sing|VerbForm=PartPres	
szolgáltatásokat	szolgáltatás	NOUN	Case=Acc|Number=Plur	
,	,	PUNCT	_	
a	a	DET	Definite=Def|PronType=Art	
nyersanyagbeszerzést	nyersanyagbeszerzés	NOUN	Case=Acc|Number=Sing	
,	,	PUNCT	_	
ételkészítési	ételkészítési	ADJ	Case=Nom|Degree=Pos|Number=Sing	
és	és	CONJ	_	
-	-	PUNCT	_	
szállítási	szállítási	ADJ	Case=Nom|Degree=Pos|Number=Sing	
feladatokat	feladat	NOUN	Case=Acc|Number=Plur	
is	is	CONJ	_	
.	.	PUNCT	_	

Ajánlattevőnek	ajánlattevő	NOUN	Case=Dat|Number=Sing	
vállalnia	vállalnia	VERB	Number=Sing|Person=3|VerbForm=Inf|Voice=Act	
kell	kell	VERB	Definite=Ind|Mood=Ind|Number=Sing|Person=3|Tense=Pres|VerbForm=Fin|Voice=Act	
,	,	PUNCT	_	
hogy	hogy	SCONJ	_	
előzetes	előzetes	ADJ	Case=Nom|Degree=Pos|Number=Sing	
egyeztetés	egyeztetés	NOUN	Case=Nom|Number=Sing	
alapján	alap	NOUN	Case=Sup|Number=Sing|Number[psor]=Sing|Person[psor]=3	
az	az	DET	Definite=Def|PronType=Art	
Ajánlatkérő	ajánlatkérő	NOUN	Case=Nom|Number=Sing	
igénye	igény	NOUN	Case=Nom|Number=Sing|Number[psor]=Sing|Person[psor]=3	
szerint	szerint	ADP	_	
protokoll	protokoll	NOUN	Case=Nom|Number=Sing	
étkezést	étkezés	NOUN	Case=Acc|Number=Sing	
és	és	CONJ	_	
rendezvények	rendezvény	NOUN	Case=Nom|Number=Plur	
ellátását	ellátás	NOUN	Case=Acc|Number=Sing|Number[psor]=Sing|Person[psor]=3	
,	,	PUNCT	_	
amelynek	amely	PRON	Case=Gen|Number=Sing|Person=3|PronType=Rel	
ellenértéke	ellenérték	NOUN	Case=Nom|Number=Sing|Number[psor]=Sing|Person[psor]=3	
a	a	DET	Definite=Def|PronType=Art	
megkötésre	megkötés	NOUN	Case=Sub|Number=Sing	
kerülő	kerülő	ADJ	Case=Nom|Degree=Pos|Number=Sing|VerbForm=PartPres	
szerződés	szerződés	NOUN	Case=Nom|Number=Sing	
átalány	átalány	NOUN	Case=Nom|Number=Sing	
vállalkozói	vállalkozói	ADJ	Case=Nom|Degree=Pos|Number=Sing	
díjának	díj	NOUN	Case=Gen|Number=Sing|Number[psor]=Sing|Person[psor]=3	
részét	rész	NOUN	Case=Acc|Number=Sing|Number[psor]=Sing|Person[psor]=3	
képezi	képez	VERB	Definite=Def|Mood=Ind|Number=Sing|Person=3|Tense=Pres|VerbForm=Fin|Voice=Act	
.	.	PUNCT	_	

Ezen	ezen	PRON	Case=Nom|Number=Sing|Person=3|PronType=Dem	
feladat	feladat	NOUN	Case=Nom|Number=Sing	
évente	évente	ADV	_	
átlagosan	átlagos	ADJ	Case=Ess|Degree=Pos|Number=Sing	
3	3	NUM	Case=Nom|NumType=Card|Number=Sing	
alkalommal	alkalom	NOUN	Case=Ins|Number=Sing	
látandó	látandó	ADJ	Case=Nom|Degree=Pos|Number=Sing|VerbForm=PartFut	
el	el	ADV	_	
,	,	PUNCT	_	
150-200	150-200	NUM	Case=Nom|NumType=Card|Number=Sing	
fő	fő	NOUN	Case=Nom|Number=Sing	
részére	részére	ADP	_	
nyújtandó	nyújtandó	ADJ	Case=Nom|Degree=Pos|Number=Sing|VerbForm=PartFut	
szolgáltatásként	szolgáltatás	NOUN	Case=Abs|Number=Sing	
.	.	PUNCT	_	

A	a	DET	Definite=Def|PronType=Art	
fizetési	fizetési	ADJ	Case=Nom|Degree=Pos|Number=Sing	
feltételeket	feltétel	NOUN	Case=Acc|Number=Plur	
a	a	DET	Definite=Def|PronType=Art	
közbeszerzési	közbeszerzési	ADJ	Case=Nom|Degree=Pos|Number=Sing	
dokumentumok	dokumentum	NOUN	Case=Nom|Number=Plur	
tartalmazzák	tartalmaz	VERB	Definite=Def|Mood=Ind|Number=Plur|Person=3|Tense=Pres|VerbForm=Fin|Voice=Act	
.	.	PUNCT	_	

A	a	DET	Definite=Def|PronType=Art	
fizetés	fizetés	NOUN	Case=Nom|Number=Sing	
elektronikus	elektronikus	ADJ	Case=Nom|Degree=Pos|Number=Sing	
úton	út	NOUN	Case=Sup|Number=Sing	
történik	történik	VERB	Definite=Ind|Mood=Ind|Number=Sing|Person=3|Tense=Pres|VerbForm=Fin|Voice=Act	
.	.	PUNCT	_	

Ajánlatkérő	ajánlatkérő	NOUN	Case=Nom|Number=Sing	
ajánlati	ajánlati	ADJ	Case=Nom|Degree=Pos|Number=Sing	
biztosítékot	biztosíték	NOUN	Case=Acc|Number=Sing	
nem	nem	ADV	PronType=Neg	
ír	ír	VERB	Definite=Ind|Mood=Ind|Number=Sing|Person=3|Tense=Pres|VerbForm=Fin|Voice=Act	
elő	elő	ADV	Degree=Pos	
.	.	PUNCT	_	

