1	1	NUM	Case=Nom|NumType=Card|Number=Sing	
darab	darab	NOUN	Case=Nom|Number=Sing	
fluoreszcencia	fluoreszcencia	NOUN	Case=Nom|Number=Sing	
alapú	alapú	ADJ	Case=Nom|Degree=Pos|Number=Sing	
sejt-szorter	sejt-szorter	NOUN	Case=Nom|Number=Sing	
beszerzése	beszerzés	NOUN	Case=Nom|Number=Sing|Number[psor]=Sing|Person[psor]=3	
a	a	DET	Definite=Def|PronType=Art	
Pécsi	Pécsi	PROPN	Case=Nom|Number=Sing	
Tudományegyetem	Tudományegyetem	PROPN	Case=Nom|Number=Sing	
GINOP-2	GINOP-2	PROPN	Case=Nom|Number=Sing	
.	.	PUNCT	_	

3	3	NUM	Case=Nom|NumType=Card|Number=Sing	
.	.	PUNCT	_	
3-15-2016-00012	3-15-2016-00012	PROPN	Case=Nom|Number=Sing	
jelű	jelű	ADJ	Case=Nom|Degree=Pos|Number=Sing	
pályázata	pályázat	NOUN	Case=Nom|Number=Sing|Number[psor]=Sing|Person[psor]=3	
keretein	keret	NOUN	Case=Sup|Number=Plur|Number[psor]=Sing|Person[psor]=3	
belül	belül	ADP	_	
adásvételi	adásvételi	ADJ	Case=Nom|Degree=Pos|Number=Sing	
szerződés	szerződés	NOUN	Case=Nom|Number=Sing	
alapján	alap	NOUN	Case=Sup|Number=Sing|Number[psor]=Sing|Person[psor]=3	
a	a	DET	Definite=Def|PronType=Art	
közbeszerzési	közbeszerzési	ADJ	Case=Nom|Degree=Pos|Number=Sing	
dokumentációban	dokumentáció	NOUN	Case=Ine|Number=Sing	
meghatározott	meghatározott	ADJ	Case=Nom|Degree=Pos|Number=Sing|VerbForm=PartPast	
paraméterekkel	paraméter	NOUN	Case=Ins|Number=Plur	
.	.	PUNCT	_	

Teljesítéssel	teljesítés	NOUN	Case=Ins|Number=Sing	
kapcsolatos	kapcsolatos	ADJ	Case=Nom|Degree=Pos|Number=Sing	
további	további	ADJ	Case=Nom|Degree=Pos|Number=Sing	
feladatok	feladat	NOUN	Case=Nom|Number=Plur	
:	:	PUNCT	_	
az	az	DET	Definite=Def|PronType=Art	
eszköz	eszköz	NOUN	Case=Nom|Number=Sing	
teljesítési	teljesítési	ADJ	Case=Nom|Degree=Pos|Number=Sing	
helyszínre	helyszín	NOUN	Case=Sub|Number=Sing	
történő	történő	ADJ	Case=Nom|Degree=Pos|Number=Sing|VerbForm=PartPres	
eljuttatása	eljuttatás	NOUN	Case=Nom|Number=Sing|Number[psor]=Sing|Person[psor]=3	
,	,	PUNCT	_	
üzembe	üzem	NOUN	Case=Ill|Number=Sing	
helyezése	helyezés	NOUN	Case=Nom|Number=Sing|Number[psor]=Sing|Person[psor]=3	
és	és	CONJ	_	
az	az	DET	Definite=Def|PronType=Art	
üzembe	üzem	NOUN	Case=Ill|Number=Sing	
helyezett	helyezett	ADJ	Case=Nom|Degree=Pos|Number=Sing|VerbForm=PartPast	
eszköz	eszköz	NOUN	Case=Nom|Number=Sing	
átadása	átadás	NOUN	Case=Nom|Number=Sing|Number[psor]=Sing|Person[psor]=3	
.	.	PUNCT	_	

Felhasználói	Felhasználói	PROPN	Case=Nom|Number=Sing	
szintű	szintű	ADJ	Case=Nom|Degree=Pos|Number=Sing	
oktatás	oktatás	NOUN	Case=Nom|Number=Sing	
:	:	PUNCT	_	
az	az	DET	Definite=Def|PronType=Art	
Eszköz	eszköz	NOUN	Case=Nom|Number=Sing	
átadás-átvételét	átadás-átvétel	NOUN	Case=Acc|Number=Sing|Number[psor]=Sing|Person[psor]=3	
követően	követő	ADJ	Case=Ess|Degree=Pos|Number=Sing|VerbForm=PartPres	
legalább	legalább	ADV	_	
4	4	NUM	Case=Nom|NumType=Card|Number=Sing	
óra	óra	NOUN	Case=Nom|Number=Sing	
időtartamban	időtartam	NOUN	Case=Ine|Number=Sing	
külön	külön	ADJ	Case=Nom|Degree=Pos|Number=Sing	
díjazás	díjazás	NOUN	Case=Nom|Number=Sing	
nélkül	nélkül	ADP	_	
az	az	DET	Definite=Def|PronType=Art	
Ajánlattevő	ajánlattevő	NOUN	Case=Nom|Number=Sing	
által	által	ADP	_	
kijelölt	kijelölt	ADJ	Case=Nom|Degree=Pos|Number=Sing|VerbForm=PartPast	
személyeknek	személy	NOUN	Case=Dat|Number=Plur	
(	(	PUNCT	_	
max	max	ADV	_	
.	.	PUNCT	_	

4	4	NUM	Case=Nom|NumType=Card|Number=Sing	
fő	fő	NOUN	Case=Nom|Number=Sing	
)	)	PUNCT	_	
.	.	PUNCT	_	

A	a	DET	Definite=Def|PronType=Art	
fuvarozással	fuvarozás	NOUN	Case=Ins|Number=Sing	
kapcsolatos	kapcsolatos	ADJ	Case=Nom|Degree=Pos|Number=Sing	
valamennyi	valamennyi	PRON	Case=Nom|Number=Sing|Person=3|PronType=Tot	
adminisztrációs	adminisztrációs	ADJ	Case=Nom|Degree=Pos|Number=Sing	
kötelezettséget	kötelezettség	NOUN	Case=Acc|Number=Sing	
teljesíti	teljesít	VERB	Definite=Def|Mood=Ind|Number=Sing|Person=3|Tense=Pres|VerbForm=Fin|Voice=Act	
a	a	DET	Definite=Def|PronType=Art	
NAV	NAV	PROPN	Case=Nom|Number=Sing	
irányába	irány	NOUN	Case=Ill|Number=Sing|Number[psor]=Sing|Person[psor]=3	
,	,	PUNCT	_	
továbbá	továbbá	ADV	_	
az	az	DET	Definite=Def|PronType=Art	
útdíjköteles	útdíjköteles	ADJ	Case=Nom|Degree=Pos|Number=Sing	
gépjárművekkel	gépjármű	NOUN	Case=Ins|Number=Plur	
a	a	DET	Definite=Def|PronType=Art	
Vevő	vevő	NOUN	Case=Nom|Number=Sing	
részére	részére	ADP	_	
végzett	végzett	ADJ	Case=Nom|Degree=Pos|Number=Sing|VerbForm=PartPast	
fuvarozással	fuvarozás	NOUN	Case=Ins|Number=Sing	
járó	járó	ADJ	Case=Nom|Degree=Pos|Number=Sing|VerbForm=PartPres	
termékszállítási	termékszállítási	ADJ	Case=Nom|Degree=Pos|Number=Sing	
bejelentési	bejelentési	ADJ	Case=Nom|Degree=Pos|Number=Sing	
kötelezettségeknek	kötelezettség	NOUN	Case=Gen|Number=Plur	
eleget	elég	NOUN	Case=Acc|Number=Sing	
tesz	tesz	VERB	Definite=Ind|Mood=Ind|Number=Sing|Person=3|Tense=Pres|VerbForm=Fin|Voice=Act	
(	(	PUNCT	_	
EKÁER	EKÁER	PROPN	Case=Nom|Number=Sing	
adminisztráció	adminisztráció	NOUN	Case=Nom|Number=Sing	
)	)	PUNCT	_	
külön	külön	ADJ	Case=Nom|Degree=Pos|Number=Sing	
díjazás	díjazás	NOUN	Case=Nom|Number=Sing	
nélkül	nélkül	ADP	_	
.	.	PUNCT	_	

