Szállítási	Szállítási	PROPN	Case=Nom|Number=Sing	
szerződés	szerződés	PROPN	Case=Nom|Number=Sing	
komplex	komplex	PROPN	Case=Nom|Number=Sing	
,	,	PUNCT	_	
biogáz	biogáz	NOUN	Case=Nom|Number=Sing	
üzemű	üzemű	ADJ	Case=Nom|Degree=Pos|Number=Sing	
cukorcirok	cukorcirok	NOUN	Case=Nom|Number=Sing	
feldolgozást	feldolgozás	NOUN	Case=Acc|Number=Sing	
és	és	CONJ	_	
cukor	cukor	NOUN	Case=Nom|Number=Sing	
szirup	szirup	NOUN	Case=Nom|Number=Sing	
gyártást	gyártás	NOUN	Case=Acc|Number=Sing	
biztosító	biztosító	ADJ	Case=Nom|Degree=Pos|Number=Sing|VerbForm=PartPres	
egyedi	egyedi	ADJ	Case=Nom|Degree=Pos|Number=Sing	
technológiához	technológia	NOUN	Case=All|Number=Sing	
kapcsolódó	kapcsolódó	ADJ	Case=Nom|Degree=Pos|Number=Sing|VerbForm=PartPres	
eszközök	eszköz	NOUN	Case=Nom|Number=Plur	
tervezése	tervezés	NOUN	Case=Nom|Number=Sing|Number[psor]=Sing|Person[psor]=3	
,	,	PUNCT	_	
szállítása	szállítás	NOUN	Case=Nom|Number=Sing|Number[psor]=Sing|Person[psor]=3	
,	,	PUNCT	_	
valamint	valamint	CONJ	_	
komplett	komplett	ADJ	Case=Nom|Degree=Pos|Number=Sing	
,	,	PUNCT	_	
kulcsrakész	kulcsrakész	ADJ	Case=Nom|Degree=Pos|Number=Sing	
telepítése	telepítés	NOUN	Case=Nom|Number=Sing|Number[psor]=Sing|Person[psor]=3	
és	és	CONJ	_	
a	a	DET	Definite=Def|PronType=Art	
hozzá	ő	PRON	Case=All|Number=Sing|Person=3|PronType=Prs	
kapcsolódó	kapcsolódó	ADJ	Case=Nom|Degree=Pos|Number=Sing|VerbForm=PartPres	
infrastrukturális	infrastrukturális	ADJ	Case=Nom|Degree=Pos|Number=Sing	
létesítmények	létesítmény	NOUN	Case=Nom|Number=Plur	
tervezésével	tervezés	NOUN	Case=Ins|Number=Sing|Number[psor]=Sing|Person[psor]=3	
és	és	CONJ	_	
kivitelezésével	kivitelezés	NOUN	Case=Ins|Number=Sing|Number[psor]=Sing|Person[psor]=3	
együtt	együtt	ADP	_	
.	.	PUNCT	_	

