EM-628	EM-628	PROPN	Case=Nom|Number=Sing	
DE	de	CONJ	_	
részére	részére	ADP	_	
sztereotaxiára	sztereotaxi	NOUN	Case=Sub|Number=Sing|Number[psor]=Sing|Person[psor]=3	
alkalmas	alkalmas	ADJ	Case=Nom|Degree=Pos|Number=Sing	
lineáris	lineáris	ADJ	Case=Nom|Degree=Pos|Number=Sing	
gyorsító	gyorsító	NOUN	Case=Nom|Number=Sing	
beszerzésére	beszerzés	NOUN	Case=Sub|Number=Sing|Number[psor]=Sing|Person[psor]=3	
irányuló	irányuló	ADJ	Case=Nom|Degree=Pos|Number=Sing|VerbForm=PartPres	
adásvételi	adásvételi	ADJ	Case=Nom|Degree=Pos|Number=Sing	
szerződés	szerződés	NOUN	Case=Nom|Number=Sing	
-	-	PUNCT	_	
eszköz	eszköz	NOUN	Case=Nom|Number=Sing	
leszállítása	leszállítás	NOUN	Case=Nom|Number=Sing|Number[psor]=Sing|Person[psor]=3	
,	,	PUNCT	_	
üzembe	üzem	NOUN	Case=Ill|Number=Sing	
helyezése	helyezés	NOUN	Case=Nom|Number=Sing|Number[psor]=Sing|Person[psor]=3	
,	,	PUNCT	_	
oktatás	oktatás	NOUN	Case=Nom|Number=Sing	
tartása	tartás	NOUN	Case=Nom|Number=Sing|Number[psor]=Sing|Person[psor]=3	
.	.	PUNCT	_	

