A	a	DET	Definite=Def|PronType=Art	
közbeszerzési	közbeszerzési	ADJ	Case=Nom|Degree=Pos|Number=Sing	
eljárás	eljárás	NOUN	Case=Nom|Number=Sing	
során	sor	NOUN	Case=Sup|Number=Sing|Number[psor]=Sing|Person[psor]=3	
a	a	DET	Definite=Def|PronType=Art	
nyertes	nyertes	ADJ	Case=Nom|Degree=Pos|Number=Sing	
ajánlattevőnek	ajánlattevő	NOUN	Case=Dat|Number=Sing	
az	az	DET	Definite=Def|PronType=Art	
ajánlatkérő	ajánlatkérő	NOUN	Case=Nom|Number=Sing	
3780	3780	NUM	Case=Nom|NumType=Card|Number=Sing	
Edelény	edelény	NOUN	Case=Nom|Number=Sing	
I.	1.	ADJ	Case=Nom|NumType=Ord|Number=Sing	
akna	akna	NOUN	Case=Nom|Number=Sing	
06	06	NUM	Case=Nom|NumType=Card|Number=Sing	
/	/	PUNCT	_	
20.	20.	ADJ	Case=Nom|NumType=Ord|Number=Sing	
szám	szám	NOUN	Case=Nom|Number=Sing	
alatti	alatti	ADJ	Case=Nom|Degree=Pos|Number=Sing	
helyszínen	helyszín	NOUN	Case=Sup|Number=Sing	
össze	össze	ADV	Degree=Pos	
kell	kell	VERB	Definite=Ind|Mood=Ind|Number=Sing|Person=3|Tense=Pres|VerbForm=Fin|Voice=Act	
állítania	állít	VERB	Number=Sing|Person=3|Tense=Pres|VerbForm=Inf|Voice=Act	
a	a	DET	Definite=Def|PronType=Art	
dokumentáció	dokumentáció	NOUN	Case=Nom|Number=Sing	
műszaki	műszaki	ADJ	Case=Nom|Degree=Pos|Number=Sing	
leírásában	leírás	NOUN	Case=Ine|Number=Sing|Number[psor]=Sing|Person[psor]=3	
meghatározott	meghatározott	ADJ	Case=Nom|Degree=Pos|Number=Sing|VerbForm=PartPast	
paramétereknek	paraméter	NOUN	Case=Dat|Number=Plur	
megfelelő	megfelelő	ADJ	Case=Nom|Degree=Pos|Number=Sing|VerbForm=PartPres	
papíripari	papíripari	ADJ	Case=Nom|Degree=Pos|Number=Sing	
anyagelőkészítő	anyagelőkészítő	ADJ	Case=Nom|Degree=Pos|Number=Sing	
rendszer	rendszer	NOUN	Case=Nom|Number=Sing	
gépet	gép	NOUN	Case=Acc|Number=Sing	
.	.	PUNCT	_	

