Keretmegállapodás	keretmegállapodás	NOUN	Case=Nom|Number=Sing	
a	a	DET	Definite=Def|PronType=Art	
rendészeti	rendészeti	ADJ	Case=Nom|Degree=Pos|Number=Sing	
továbbképzési	továbbképzési	ADJ	Case=Nom|Degree=Pos|Number=Sing	
feladatok	feladat	NOUN	Case=Nom|Number=Plur	
ellátásához	ellátás	NOUN	Case=All|Number=Sing|Number[psor]=Sing|Person[psor]=3	
szükséges	szükséges	ADJ	Case=Nom|Degree=Pos|Number=Sing	
tananyag	tananyag	NOUN	Case=Nom|Number=Sing	
fejlesztési	fejlesztési	ADJ	Case=Nom|Degree=Pos|Number=Sing	
szolgáltatások	szolgáltatás	NOUN	Case=Nom|Number=Plur	
beszerzésére-nettó	beszerzésére-nettó	NOUN	Case=Nom|Number=Sing	
60	60	NUM	Case=Nom|NumType=Card|Number=Sing	
000	000	NUM	Case=Nom|NumType=Card|Number=Sing	
000	000	NUM	Case=Nom|NumType=Card|Number=Sing	
HUF	HUF	PROPN	Case=Nom|Number=Sing	
keretösszegben	keretösszeg	NOUN	Case=Ine|Number=Sing	
.	.	PUNCT	_	

Ajánlatkérő	ajánlatkérő	NOUN	Case=Nom|Number=Sing	
a	a	DET	Definite=Def|PronType=Art	
közbeszerzés	közbeszerzés	NOUN	Case=Nom|Number=Sing	
mennyiségét	mennyiség	NOUN	Case=Acc|Number=Sing|Number[psor]=Sing|Person[psor]=3	
a	a	DET	Definite=Def|PronType=Art	
rendelkezésre	rendelkezés	NOUN	Case=Sub|Number=Sing	
álló	álló	ADJ	Case=Nom|Degree=Pos|Number=Sing|VerbForm=PartPres	
keretösszeg	keretösszeg	NOUN	Case=Nom|Number=Sing	
(	(	PUNCT	_	
amely	amely	PRON	Case=Nom|Number=Sing|Person=3|PronType=Rel	
megegyezik	megegyezik	VERB	Definite=Ind|Mood=Ind|Number=Sing|Person=3|Tense=Pres|VerbForm=Fin|Voice=Act	
a	a	DET	Definite=Def|PronType=Art	
becsült	becsült	ADJ	Case=Nom|Degree=Pos|Number=Sing|VerbForm=PartPast	
értékkel	érték	NOUN	Case=Ins|Number=Sing	
)	)	PUNCT	_	
megadásával	megadás	NOUN	Case=Ins|Number=Sing|Number[psor]=Sing|Person[psor]=3	
határozza	határoz	VERB	Definite=Def|Mood=Ind|Number=Sing|Person=3|Tense=Pres|VerbForm=Fin|Voice=Act	
meg	meg	PART	_	
,	,	PUNCT	_	
a	a	DET	Definite=Def|PronType=Art	
keretösszeg	keretösszeg	NOUN	Case=Nom|Number=Sing	
erejéig	erő	NOUN	Case=Ter|Number=Sing|Number[psor]=Sing|Person[psor]=3	
megrendelhető	megrendelhető	ADJ	Case=Nom|Degree=Pos|Number=Sing|VerbForm=PartPres	
teljes	teljes	ADJ	Case=Nom|Degree=Pos|Number=Sing	
mennyiség	mennyiség	NOUN	Case=Nom|Number=Sing	
előre	előre	ADV	Degree=Pos	
pontosan	pontos	ADJ	Case=Ess|Degree=Pos|Number=Sing	
nem	nem	ADV	PronType=Neg	
határozható	határozható	ADJ	Case=Nom|Degree=Pos|Number=Sing|VerbForm=PartPres	
meg	meg	PART	_	
.	.	PUNCT	_	

Ajánlatkérő	ajánlatkérő	NOUN	Case=Nom|Number=Sing	
a	a	DET	Definite=Def|PronType=Art	
várható	várható	ADJ	Case=Nom|Degree=Pos|Number=Sing|VerbForm=PartPres	
mennyiségeket	mennyiség	NOUN	Case=Acc|Number=Plur	
közli	közöl	VERB	Definite=Def|Mood=Ind|Number=Sing|Person=3|Tense=Pres|VerbForm=Fin|Voice=Act	
azzal	az	PRON	Case=Ins|Number=Sing|Person=3|PronType=Dem	
,	,	PUNCT	_	
hogy	hogy	SCONJ	_	
Ajánlatkérőnek	ajánlatkérő	NOUN	Case=Dat|Number=Sing	
a	a	DET	Definite=Def|PronType=Art	
keretmegállapodás	keretmegállapodás	NOUN	Case=Nom|Number=Sing	
alapján	alap	NOUN	Case=Sup|Number=Sing|Number[psor]=Sing|Person[psor]=3	
előre	előre	ADV	Degree=Pos	
vállalt	vállalt	ADJ	Case=Nom|Degree=Pos|Number=Sing|VerbForm=PartPast	
beszerzési	beszerzési	ADJ	Case=Nom|Degree=Pos|Number=Sing	
kötelezettsége	kötelezettség	NOUN	Case=Nom|Number=Sing|Number[psor]=Sing|Person[psor]=3	
nincs	nincs	VERB	Definite=Ind|Mood=Ind|Number=Sing|Person=3|Tense=Pres|VerbForm=Fin|Voice=Act	
,	,	PUNCT	_	
kötelezettség	kötelezettség	NOUN	Case=Nom|Number=Sing	
vállalás	vállalás	NOUN	Case=Nom|Number=Sing	
kizárólag	kizárólag	ADV	_	
a	a	DET	Definite=Def|PronType=Art	
KM	km	NOUN	Case=Nom|Number=Sing	
eljárás	eljárás	NOUN	Case=Nom|Number=Sing	
második	második	ADJ	Case=Nom|NumType=Ord|Number=Sing	
részének	rész	NOUN	Case=Gen|Number=Sing|Number[psor]=Sing|Person[psor]=3	
lefolytatásakor	lefolytatás	NOUN	Case=Tem|Number=Sing|Number[psor]=Sing|Person[psor]=3	
keletkezik	keletkezik	VERB	Definite=Ind|Mood=Ind|Number=Sing|Person=3|Tense=Pres|VerbForm=Fin|Voice=Act	
.	.	PUNCT	_	

Részletes	részletes	ADJ	Case=Nom|Degree=Pos|Number=Sing	
követelmények	követelmény	NOUN	Case=Nom|Number=Plur	
a	a	DET	Definite=Def|PronType=Art	
közbeszerzési	közbeszerzési	ADJ	Case=Nom|Degree=Pos|Number=Sing	
dokumentumokban	dokumentum	NOUN	Case=Ine|Number=Plur	
.	.	PUNCT	_	

