Vállalkozási	Vállalkozási	PROPN	Case=Nom|Number=Sing	
szerződés	szerződés	NOUN	Case=Nom|Number=Sing	
a	a	DET	Definite=Def|PronType=Art	
Földművelésügyi	Földművelésügyi	PROPN	Case=Nom|Number=Sing	
Minisztérium	Minisztérium	PROPN	Case=Nom|Number=Sing	
egyes	egyes	ADJ	Case=Nom|Degree=Pos|Number=Sing	
kiemelt	kiemelt	NOUN	Case=Nom|Number=Sing	
informatikai	informatikai	ADJ	Case=Nom|Degree=Pos|Number=Sing	
rendszereinek	rendszer	NOUN	Case=Gen|Number=Plur|Number[psor]=Sing|Person[psor]=3	
alapinfrastruktúrához	alapinfrastruktúra	NOUN	Case=All|Number=Sing	
és	és	CONJ	_	
szoftveralkalmazásaihoz	szoftveralkalmazás	NOUN	Case=All|Number=Plur|Number[psor]=Sing|Person[psor]=3	
kapcsolódó	kapcsolódó	ADJ	Case=Nom|Degree=Pos|Number=Sing|VerbForm=PartPres	
üzemeltetés-támogatási	üzemeltetés-támogatási	ADJ	Case=Nom|Degree=Pos|Number=Sing	
feladatok	feladat	NOUN	Case=Nom|Number=Plur	
(	(	PUNCT	_	
support	support	NOUN	Case=Nom|Number=Sing	
)	)	PUNCT	_	
ellátásának	ellátás	NOUN	Case=Gen|Number=Sing|Number[psor]=Sing|Person[psor]=3	
biztosítására	biztosítás	NOUN	Case=Sub|Number=Sing|Number[psor]=Sing|Person[psor]=3	
.	.	PUNCT	_	

