Vállalkozási	Vállalkozási	PROPN	Case=Nom|Number=Sing	
szerződés	szerződés	NOUN	Case=Nom|Number=Sing	
az	az	DET	Definite=Def|PronType=Art	
alábbi	alábbi	ADJ	Case=Nom|Degree=Pos|Number=Sing	
tárgyban	tárgy	NOUN	Case=Ine|Number=Sing	
:	:	PUNCT	_	
A	a	DET	Definite=Def|PronType=Art	
Kaposvári	kaposvári	ADJ	Case=Nom|Degree=Pos|Number=Sing	
Egyetem	Egyetem	PROPN	Case=Nom|Number=Sing	
Egészségügyi	Egészségügyi	PROPN	Case=Nom|Number=Sing	
Centrum	Centrum	PROPN	Case=Nom|Number=Sing	
orvostechnológiai	orvostechnológiai	ADJ	Case=Nom|Degree=Pos|Number=Sing	
berendezéseinek	berendezés	NOUN	Case=Gen|Number=Plur|Number[psor]=Sing|Person[psor]=3	
,	,	PUNCT	_	
valamint	valamint	CONJ	_	
az	az	DET	Definite=Def|PronType=Art	
orvostechnológiai	orvostechnológiai	ADJ	Case=Nom|Degree=Pos|Number=Sing	
berendezésekhez	berendezés	NOUN	Case=All|Number=Plur	
kapcsolódó	kapcsolódó	ADJ	Case=Nom|Degree=Pos|Number=Sing|VerbForm=PartPres	
épületgépészeti	épületgépészeti	ADJ	Case=Nom|Degree=Pos|Number=Sing	
,	,	PUNCT	_	
és	és	CONJ	_	
egyéb	egyéb	PRON	Case=Nom|Number=Sing|Person=3|PronType=Ind	
műszaki	műszaki	ADJ	Case=Nom|Degree=Pos|Number=Sing	
berendezéseinek	berendezés	NOUN	Case=Gen|Number=Plur|Number[psor]=Sing|Person[psor]=3	
műszaki	műszaki	ADJ	Case=Nom|Degree=Pos|Number=Sing	
üzemfenntartása	üzemfenntartás	NOUN	Case=Nom|Number=Sing|Number[psor]=Sing|Person[psor]=3	
,	,	PUNCT	_	
karbantartása	karbantartás	NOUN	Case=Nom|Number=Sing|Number[psor]=Sing|Person[psor]=3	
és	és	CONJ	_	
szervizelése	szervizelés	NOUN	Case=Nom|Number=Sing|Number[psor]=Sing|Person[psor]=3	

