A	a	DET	Definite=Def|PronType=Art	
Nemzeti	Nemzeti	PROPN	Case=Nom|Number=Sing	
Adó	Adó	PROPN	Case=Nom|Number=Sing	
-	-	PUNCT	_	
és	és	CONJ	_	
Vámhivatal	vámhivatal	NOUN	Case=Nom|Number=Sing	
Közép-dunántúli	Közép-dunántúli	ADJ	Case=Nom|Degree=Pos|Number=Sing	
Regionális	Regionális	PROPN	Case=Nom|Number=Sing	
Adó	Adó	PROPN	Case=Nom|Number=Sing	
Főigazgatósága	főigazgatósága	NOUN	Case=Nom|Number=Sing	
telephelyeire	telephely	NOUN	Case=Sub|Number=Plur|Number[psor]=Sing|Person[psor]=3	
beérkező	beérkező	ADJ	Case=Nom|Degree=Pos|Number=Sing|VerbForm=PartPres	
adóbevallások	adóbevallás	NOUN	Case=Nom|Number=Plur	
számítógépes	számítógépes	ADJ	Case=Nom|Degree=Pos|Number=Sing	
adatrögzítése	adatrögzítés	NOUN	Case=Nom|Number=Sing|Number[psor]=Sing|Person[psor]=3	
és	és	CONJ	_	
a	a	DET	Definite=Def|PronType=Art	
feldolgozásához	feldolgozás	NOUN	Case=All|Number=Sing|Number[psor]=Sing|Person[psor]=3	
kapcsolódó	kapcsolódó	ADJ	Case=Nom|Degree=Pos|Number=Sing|VerbForm=PartPres	
adminisztratív	adminisztratív	ADJ	Case=Nom|Degree=Pos|Number=Sing	
feladatok	feladat	NOUN	Case=Nom|Number=Plur	
ellátása	ellátás	NOUN	Case=Nom|Number=Sing|Number[psor]=Sing|Person[psor]=3	
.	.	PUNCT	_	

