Jávorszky	jávorszky	NOUN	Case=Nom|Number=Sing	
Ödön	ödön	NOUN	Case=Nom|Number=Sing	
Kórház	Kórház	PROPN	Case=Nom|Number=Sing	
bővítéses	bővítéses	ADJ	Case=Nom|Degree=Pos|Number=Sing	
korszerűsítése	korszerűsítés	NOUN	Case=Nom|Number=Sing|Number[psor]=Sing|Person[psor]=3	
KMOP-4	KMOP-4	PROPN	Case=Nom|Number=Sing	
.	.	PUNCT	_	

3.1	3.1	PROPN	Case=Nom|Number=Sing	
/	/	PUNCT	_	
A-2009-0002	A-2009-0002	PROPN	Case=Nom|Number=Sing	
projekt	projekt	NOUN	Case=Nom|Number=Sing	
,	,	PUNCT	_	
szakmai	szakmai	ADJ	Case=Nom|Degree=Pos|Number=Sing	
célkitűzéseit	célkitűzés	NOUN	Case=Acc|Number=Plur|Number[psor]=Sing|Person[psor]=3	
támogató	támogató	ADJ	Case=Nom|Degree=Pos|Number=Sing|VerbForm=PartPres	
gép-műszer-eszköz	gép-műszer-eszköz	NOUN	Case=Nom|Number=Sing	
beszerzés	beszerzés	NOUN	Case=Nom|Number=Sing	
Szállítási	Szállítási	PROPN	Case=Nom|Number=Sing	
szerződés	szerződés	NOUN	Case=Nom|Number=Sing	
a	a	DET	Definite=Def|PronType=Art	
Jávorszky	jávorszky	NOUN	Case=Nom|Number=Sing	
Ödön	ödön	NOUN	Case=Nom|Number=Sing	
Kórház	Kórház	PROPN	Case=Nom|Number=Sing	
bővítéses	bővítéses	ADJ	Case=Nom|Degree=Pos|Number=Sing	
korszerűsítése	korszerűsítés	NOUN	Case=Nom|Number=Sing|Number[psor]=Sing|Person[psor]=3	
során	sor	NOUN	Case=Sup|Number=Sing|Number[psor]=Sing|Person[psor]=3	
beszerzésre	beszerzés	NOUN	Case=Sub|Number=Sing	
kerülő	kerülő	ADJ	Case=Nom|Degree=Pos|Number=Sing|VerbForm=PartPres	
orvosi	orvosi	ADJ	Case=Nom|Degree=Pos|Number=Sing	
gép-műszerek	gép-műszer	NOUN	Case=Nom|Number=Plur	
és	és	CONJ	_	
tartozékaik	tartozék	NOUN	Case=Nom|Number=Plur|Number[psor]=Plur|Person[psor]=3	
szállítása	szállítás	NOUN	Case=Nom|Number=Sing|Number[psor]=Sing|Person[psor]=3	
,	,	PUNCT	_	
összeszerelése	összeszerelés	NOUN	Case=Nom|Number=Sing|Number[psor]=Sing|Person[psor]=3	
,	,	PUNCT	_	
üzembehelyezése	üzembehelyezés	NOUN	Case=Nom|Number=Sing|Number[psor]=Sing|Person[psor]=3	
,	,	PUNCT	_	
a	a	DET	Definite=Def|PronType=Art	
kezelőszemélyzet	kezelőszemélyzet	NOUN	Case=Nom|Number=Sing	
oktatásának	oktatás	NOUN	Case=Gen|Number=Sing|Number[psor]=Sing|Person[psor]=3	
elvégzése	elvégzés	NOUN	Case=Nom|Number=Sing|Number[psor]=Sing|Person[psor]=3	
,	,	PUNCT	_	
próbaüzem	próbaüzem	NOUN	Case=Nom|Number=Sing	
elvégzése	elvégzés	NOUN	Case=Nom|Number=Sing|Number[psor]=Sing|Person[psor]=3	
valamint	valamint	CONJ	_	
a	a	DET	Definite=Def|PronType=Art	
garanciális	garanciális	ADJ	Case=Nom|Degree=Pos|Number=Sing	
és	és	CONJ	_	
jótállási	jótállási	ADJ	Case=Nom|Degree=Pos|Number=Sing	
feladatok	feladat	NOUN	Case=Nom|Number=Plur	
ellátása	ellátás	NOUN	Case=Nom|Number=Sing|Number[psor]=Sing|Person[psor]=3	
.	.	PUNCT	_	

