Közszolgáltatási	közszolgáltatási	ADJ	Case=Nom|Degree=Pos|Number=Sing	
szerződés	szerződés	NOUN	Case=Nom|Number=Sing	
Csokonyavisonta	csokonyavisonta	NOUN	Case=Nom|Number=Sing	
község	község	NOUN	Case=Nom|Number=Sing	
területén	terület	NOUN	Case=Sup|Number=Sing|Number[psor]=Sing|Person[psor]=3	
keletkező	keletkező	ADJ	Case=Nom|Degree=Pos|Number=Sing|VerbForm=PartPres	
lakossági	lakossági	ADJ	Case=Nom|Degree=Pos|Number=Sing	
és	és	CONJ	_	
közületi	közületi	ADJ	Case=Nom|Degree=Pos|Number=Sing	
szilárd	szilárd	ADJ	Case=Nom|Degree=Pos|Number=Sing	
hulladék	hulladék	NOUN	Case=Nom|Number=Sing	
begyűjtésével	begyűjtés	NOUN	Case=Ins|Number=Sing|Number[psor]=Sing|Person[psor]=3	
,	,	PUNCT	_	
elszállításával	elszállítás	NOUN	Case=Ins|Number=Sing|Number[psor]=Sing|Person[psor]=3	
és	és	CONJ	_	
ártalmatlanításával	ártalmatlanítás	NOUN	Case=Ins|Number=Sing|Number[psor]=Sing|Person[psor]=3	
kapcsolatos	kapcsolatos	ADJ	Case=Nom|Degree=Pos|Number=Sing	
közszolgáltatói	közszolgáltató	ADJ	Case=Nom|Degree=Pos|Number=Plur|Number[psor]=Sing|Person[psor]=3|VerbForm=PartPres	
feladatok	feladat	NOUN	Case=Nom|Number=Plur	
ellátására	ellátás	NOUN	Case=Sub|Number=Sing|Number[psor]=Sing|Person[psor]=3	
.	.	PUNCT	_	

