Intel	Intel	PROPN	Case=Nom|Number=Sing	
és	és	CONJ	_	
Alpha	Alpha	PROPN	Case=Nom|Number=Sing	
szerverek	szerver	NOUN	Case=Nom|Number=Plur	
,	,	PUNCT	_	
mentőegységek	mentőegység	NOUN	Case=Nom|Number=Plur	
,	,	PUNCT	_	
tárolók	tároló	NOUN	Case=Nom|Number=Plur	
,	,	PUNCT	_	
LAN	LAN	NOUN	Case=Nom|Number=Sing	
és	és	CONJ	_	
SAN	san	NOUN	Case=Nom|Number=Sing	
eszközök	eszköz	NOUN	Case=Nom|Number=Plur	
hardver	hardver	NOUN	Case=Nom|Number=Sing	
szintű	szintű	ADJ	Case=Nom|Degree=Pos|Number=Sing	
támogatása	támogatás	NOUN	Case=Nom|Number=Sing|Number[psor]=Sing|Person[psor]=3	
érdekében	érdek	NOUN	Case=Ine|Number=Sing|Number[psor]=Sing|Person[psor]=3	
nyújtott	nyújtott	ADJ	Case=Nom|Degree=Pos|Number=Sing|VerbForm=PartPast	
üzemeltetést	üzemeltetés	NOUN	Case=Acc|Number=Sing	
biztosító	biztosító	ADJ	Case=Nom|Degree=Pos|Number=Sing|VerbForm=PartPres	
szakértői	szakértői	ADJ	Case=Nom|Degree=Pos|Number=Sing	
szolgáltatás	szolgáltatás	NOUN	Case=Nom|Number=Sing	
(	(	PUNCT	_	
hardver	hardver	NOUN	Case=Nom|Number=Sing	
hibajavítás	hibajavítás	NOUN	Case=Nom|Number=Sing	
,	,	PUNCT	_	
hardverkarbantartás	hardverkarbantartás	NOUN	Case=Nom|Number=Sing	
,	,	PUNCT	_	
tanácsadás	tanácsadás	NOUN	Case=Nom|Number=Sing	
,	,	PUNCT	_	
Firmware	Firmware	PROPN	Case=Nom|Number=Sing	
frissítések	frissítés	NOUN	Case=Nom|Number=Plur	
legalább	legalább	ADV	_	
egy	egy	NUM	Case=Nom|NumType=Card|Number=Sing	
alkalommal	alkalom	NOUN	Case=Ins|Number=Sing	
történő	történő	ADJ	Case=Nom|Degree=Pos|Number=Sing|VerbForm=PartPres	
telepítése	telepítés	NOUN	Case=Nom|Number=Sing|Number[psor]=Sing|Person[psor]=3	
)	)	PUNCT	_	
meghatározott	meghatározott	ADJ	Case=Nom|Degree=Pos|Number=Sing|VerbForm=PartPast	
szolgáltatási	szolgáltatási	ADJ	Case=Nom|Degree=Pos|Number=Sing	
szint	szint	NOUN	Case=Nom|Number=Sing	
biztosítása	biztosítás	NOUN	Case=Nom|Number=Sing|Number[psor]=Sing|Person[psor]=3	
mellett	mellett	ADP	_	
.	.	PUNCT	_	

