Budapest	Budapest	PROPN	Case=Nom|Number=Sing	
XVIII	18	NUM	Case=Nom|NumType=Card|Number=Sing	
.	.	PUNCT	_	
kerület	kerület	NOUN	Case=Nom|Number=Sing	
Pestszentimre-Pestszentlőrinc	Pestszentimre-pestszentlőrinc	NOUN	Case=Nom|Number=Sing	
Önkormányzata	Önkormányzata	PROPN	Case=Nom|Number=Sing	
fenntartása	fenntartás	NOUN	Case=Nom|Number=Sing|Number[psor]=Sing|Person[psor]=3	
alatt	alatt	ADP	_	
álló	álló	ADJ	Case=Nom|Degree=Pos|Number=Sing|VerbForm=PartPres	
intézmények	intézmény	NOUN	Case=Nom|Number=Plur	
részére	részére	ADP	_	
ételkiszállítással	ételkiszállítás	NOUN	Case=Ins|Number=Sing	
történő	történő	ADJ	Case=Nom|Degree=Pos|Number=Sing|VerbForm=PartPres	
közétkeztetés	közétkeztetés	NOUN	Case=Nom|Number=Sing	
biztosítása	biztosítás	NOUN	Case=Nom|Number=Sing|Number[psor]=Sing|Person[psor]=3	
2016.	2016.	ADJ	Case=Nom|NumType=Ord|Number=Sing	

Az	az	DET	Definite=Def|PronType=Art	
ajánlatok	ajánlat	NOUN	Case=Nom|Number=Plur	
részszempontok	részszempont	NOUN	Case=Nom|Number=Plur	
szerinti	szerinti	ADJ	Case=Nom|Degree=Pos|Number=Sing	
tartalmi	tartalmi	ADJ	Case=Nom|Degree=Pos|Number=Sing	
elemeinek	elem	NOUN	Case=Gen|Number=Plur|Number[psor]=Sing|Person[psor]=3	
értékelése	értékelés	NOUN	Case=Nom|Number=Sing|Number[psor]=Sing|Person[psor]=3	
során	sor	NOUN	Case=Sup|Number=Sing|Number[psor]=Sing|Person[psor]=3	
adható	adható	ADJ	Case=Nom|Degree=Pos|Number=Sing|VerbForm=PartPres	
pontszám	pontszám	NOUN	Case=Nom|Number=Sing	
alsó	alsó	ADJ	Case=Nom|Degree=Pos|Number=Sing	
és	és	CONJ	_	
felső	felső	ADJ	Case=Nom|Degree=Pos|Number=Sing	
határa	határ	NOUN	Case=Nom|Number=Sing|Number[psor]=Sing|Person[psor]=3	
:	:	PUNCT	_	
1-10	1-10	NUM	Case=Nom|NumType=Card|Number=Sing	
pont	pont	NOUN	Case=Nom|Number=Sing	
.	.	PUNCT	_	

A	a	DET	Definite=Def|PronType=Art	
részszempontok	részszempont	NOUN	Case=Nom|Number=Plur	
értékelése	értékelés	NOUN	Case=Nom|Number=Sing|Number[psor]=Sing|Person[psor]=3	
az	az	DET	Definite=Def|PronType=Art	
1-4	1-4	NUM	Case=Nom|NumType=Card|Number=Sing	
.	.	PUNCT	_	
értékelési	értékelési	ADJ	Case=Nom|Degree=Pos|Number=Sing	
részszempontok	részszempont	NOUN	Case=Nom|Number=Plur	
(	(	PUNCT	_	
adagárak	adagár	NOUN	Case=Nom|Number=Plur	
)	)	PUNCT	_	
esetében	eset	NOUN	Case=Ine|Number=Sing|Number[psor]=Sing|Person[psor]=3	
az	az	DET	Definite=Def|PronType=Art	
értékarányosítás	értékarányosítás	NOUN	Case=Nom|Number=Sing	
módszerével	módszer	NOUN	Case=Ins|Number=Sing|Number[psor]=Sing|Person[psor]=3	
történik	történik	VERB	Definite=Ind|Mood=Ind|Number=Sing|Person=3|Tense=Pres|VerbForm=Fin|Voice=Act	
.	.	PUNCT	_	

Az	az	DET	Definite=Def|PronType=Art	
5.	5.	ADJ	Case=Nom|NumType=Ord|Number=Sing	
értékelési	értékelési	ADJ	Case=Nom|Degree=Pos|Number=Sing	
részszempont	részszempont	NOUN	Case=Nom|Number=Sing	
(	(	PUNCT	_	
étlapok	étlap	NOUN	Case=Nom|Number=Plur	
)	)	PUNCT	_	
értékelése	értékelés	NOUN	Case=Nom|Number=Sing|Number[psor]=Sing|Person[psor]=3	
a	a	DET	Definite=Def|PronType=Art	
pontozás	pontozás	NOUN	Case=Nom|Number=Sing	
módszerével	módszer	NOUN	Case=Ins|Number=Sing|Number[psor]=Sing|Person[psor]=3	
történik	történik	VERB	Definite=Ind|Mood=Ind|Number=Sing|Person=3|Tense=Pres|VerbForm=Fin|Voice=Act	
.	.	PUNCT	_	

