Villamos	Villamos	PROPN	Case=Nom|Number=Sing	
energia	energia	NOUN	Case=Nom|Number=Sing	
adás-vételi	adás-vételi	ADJ	Case=Nom|Degree=Pos|Number=Sing	
szerződés	szerződés	NOUN	Case=Nom|Number=Sing	
ajánlatkérő	ajánlatkérő	NOUN	Case=Nom|Number=Sing	
vagyonkezelésében	vagyonkezelés	NOUN	Case=Ine|Number=Sing|Number[psor]=Sing|Person[psor]=3	
lévő	lévő	ADJ	Case=Nom|Degree=Pos|Number=Sing|VerbForm=PartPres	
ingatlanok	ingatlan	NOUN	Case=Nom|Number=Plur	
részére	részére	ADP	_	
a	a	DET	Definite=Def|PronType=Art	
magyar	magyar	ADJ	Case=Nom|Degree=Pos|Number=Sing	
villamos	villamos	ADJ	Case=Nom|Degree=Pos|Number=Sing	
energia	energia	NOUN	Case=Nom|Number=Sing	
átviteli	átviteli	ADJ	Case=Nom|Degree=Pos|Number=Sing	
hálózaton	hálózat	NOUN	Case=Sup|Number=Sing	
folyamatosan	folyamatos	ADJ	Case=Ess|Degree=Pos|Number=Sing	
rendelkezésre	rendelkezés	NOUN	Case=Sub|Number=Sing	
álló	álló	ADJ	Case=Nom|Degree=Pos|Number=Sing|VerbForm=PartPres	
,	,	PUNCT	_	
a	a	DET	Definite=Def|PronType=Art	
felhasználási	felhasználási	ADJ	Case=Nom|Degree=Pos|Number=Sing	
helyek	hely	NOUN	Case=Nom|Number=Plur	
csatlakozási	csatlakozási	ADJ	Case=Nom|Degree=Pos|Number=Sing	
jellemzőinek	jellemző	NOUN	Case=Dat|Number=Plur|Number[psor]=Sing|Person[psor]=3	
megfelelő	megfelelő	ADJ	Case=Nom|Degree=Pos|Number=Sing	
minőségű	minőségű	ADJ	Case=Nom|Degree=Pos|Number=Sing	
villamos	villamos	ADJ	Case=Nom|Degree=Pos|Number=Sing	
energia	energia	NOUN	Case=Nom|Number=Sing	
beszerzése	beszerzés	NOUN	Case=Nom|Number=Sing|Number[psor]=Sing|Person[psor]=3	
(	(	PUNCT	_	
kereskedelmi	kereskedelmi	ADJ	Case=Nom|Degree=Pos|Number=Sing	
jogviszonyban	jogviszony	NOUN	Case=Ine|Number=Sing	
való	való	ADJ	Case=Nom|Degree=Pos|Number=Sing|VerbForm=PartPres	
megvásárlása	megvásárlás	NOUN	Case=Nom|Number=Sing|Number[psor]=Sing|Person[psor]=3	
)	)	PUNCT	_	
12	12	NUM	Case=Nom|NumType=Card|Number=Sing	
hónapos	hónapos	ADJ	Case=Nom|Degree=Pos|Number=Sing	
időszakra	időszak	NOUN	Case=Sub|Number=Sing	
vonatkozóan	vonatkozó	ADJ	Case=Ess|Degree=Pos|Number=Sing|VerbForm=PartPres	
,	,	PUNCT	_	
menetrend	menetrend	NOUN	Case=Nom|Number=Sing	
adási	adási	ADJ	Case=Nom|Degree=Pos|Number=Sing	
kötelezettség	kötelezettség	NOUN	Case=Nom|Number=Sing	
nélküli	nélküli	ADJ	Case=Nom|Degree=Pos|Number=Sing	
teljes	teljes	ADJ	Case=Nom|Degree=Pos|Number=Sing	
ellátásalapú	ellátásalapú	ADJ	Case=Nom|Degree=Pos|Number=Sing	
villamos	villamos	ADJ	Case=Nom|Degree=Pos|Number=Sing	
energia	energia	NOUN	Case=Nom|Number=Sing	
adás-vételi	adás-vételi	ADJ	Case=Nom|Degree=Pos|Number=Sing	
szerződés	szerződés	NOUN	Case=Nom|Number=Sing	
keretében	keret	NOUN	Case=Ine|Number=Sing|Number[psor]=Sing|Person[psor]=3	
,	,	PUNCT	_	
amely	amely	PRON	Case=Nom|Number=Sing|Person=3|PronType=Rel	
nem	nem	ADV	PronType=Neg	
foglalja	foglal	VERB	Definite=Def|Mood=Ind|Number=Sing|Person=3|Tense=Pres|VerbForm=Fin|Voice=Act	
magában	maga	PRON	Case=Ine|Number=Sing|Person=3|Reflex=Yes	
a	a	DET	Definite=Def|PronType=Art	
rendszerhasználati	rendszerhasználati	ADJ	Case=Nom|Degree=Pos|Number=Sing	
díjak	díj	NOUN	Case=Nom|Number=Plur	
elszámolását	elszámolás	NOUN	Case=Acc|Number=Sing|Number[psor]=Sing|Person[psor]=3	
(	(	PUNCT	_	
a	a	DET	Definite=Def|PronType=Art	
rendszerhasználati	rendszerhasználati	ADJ	Case=Nom|Degree=Pos|Number=Sing	
díjakat	díj	NOUN	Case=Acc|Number=Plur	
a	a	DET	Definite=Def|PronType=Art	
hálózati	hálózati	ADJ	Case=Nom|Degree=Pos|Number=Sing	
engedélyesek	engedélyes	NOUN	Case=Nom|Number=Plur	
közvetlenül	közvetlen	ADJ	Case=Ess|Degree=Pos|Number=Sing	
érvényesítik	érvényesít	VERB	Definite=Def|Mood=Ind|Number=Plur|Person=3|Tense=Pres|VerbForm=Fin|Voice=Act	
ajánlatkérő	ajánlatkérő	NOUN	Case=Nom|Number=Sing	
(	(	PUNCT	_	
k	k	NOUN	Case=Nom|Number=Sing	
)	)	PUNCT	_	
el	el	ADV	_	
szemben	szemben	ADP	_	
)	)	PUNCT	_	
.	.	PUNCT	_	

