Megbízási	megbízási	ADJ	Case=Nom|Degree=Pos|Number=Sing	
szerződés	szerződés	NOUN	Case=Nom|Number=Sing	
a	a	DET	Definite=Def|PronType=Art	
„	„	PUNCT	_	
Kiskunhalas	kiskunhalas	NOUN	Case=Nom|Number=Sing	
Ivóvízminőség-javító	Ivóvízminőség-javító	NOUN	Case=Nom|Number=Sing	
Projekt	Projekt	PROPN	Case=Nom|Number=Sing	
"	"	PUNCT	_	
című	című	ADJ	Case=Nom|Degree=Pos|Number=Sing	
KEOP-1	KEOP-1	PROPN	Case=Nom|Number=Sing	
.	.	PUNCT	_	

3.0	3.0	PROPN	Case=Nom|Number=Sing	
/	/	PUNCT	_	
09-11-2011-0028	09-11-2011-0028	PROPN	Case=Nom|Number=Sing	
azonosító	azonosító	ADJ	Case=Nom|Degree=Pos|Number=Sing|VerbForm=PartPres	
számú	számú	ADJ	Case=Nom|Degree=Pos|Number=Sing	
projekttel	projekt	NOUN	Case=Ins|Number=Sing	
kapcsolatos	kapcsolatos	ADJ	Case=Nom|Degree=Pos|Number=Sing	
FIDIC	FIDIC	PROPN	Case=Nom|Number=Sing	
mérnöki	mérnöki	ADJ	Case=Nom|Degree=Pos|Number=Sing	
és	és	CONJ	_	
műszaki	műszaki	ADJ	Case=Nom|Degree=Pos|Number=Sing	
ellenőri	ellenőri	ADJ	Case=Nom|Degree=Pos|Number=Sing	
feladatok	feladat	NOUN	Case=Nom|Number=Plur	
ellátására	ellátás	NOUN	Case=Sub|Number=Sing|Number[psor]=Sing|Person[psor]=3	
.	.	PUNCT	_	

