Pest	Pest	PROPN	Case=Nom|Number=Sing	
Megyei	Megyei	PROPN	Case=Nom|Number=Sing	
Rendőr-főkapitányság	Rendőr-főkapitányság	PROPN	Case=Nom|Number=Sing	
Skoda	Skoda	PROPN	Case=Nom|Number=Sing	
Yeti	Yeti	PROPN	Case=Nom|Number=Sing	
1.8	1.8	PROPN	Case=Nom|Number=Sing	
TSI	TSI	PROPN	Case=Nom|Number=Sing	
és	és	CONJ	_	
2.0	2.0	PROPN	Case=Nom|Number=Sing	
CRTDI	CRTDI	PROPN	Case=Nom|Number=Sing	
és	és	CONJ	_	
Skoda	Skoda	PROPN	Case=Nom|Number=Sing	
Fabia	Fabia	PROPN	Case=Nom|Number=Sing	
1.2	1.2	PROPN	Case=Nom|Number=Sing	
TSI	TSI	PROPN	Case=Nom|Number=Sing	
gépjárműveinek	gépjármű	NOUN	Case=Gen|Number=Plur|Number[psor]=Sing|Person[psor]=3	
garanciaidőn	garanciaidő	NOUN	Case=Sup|Number=Sing	
túli	túli	ADJ	Case=Nom|Degree=Pos|Number=Sing	
karbantartása	karbantartás	NOUN	Case=Nom|Number=Sing|Number[psor]=Sing|Person[psor]=3	
,	,	PUNCT	_	
javítása	javítás	NOUN	Case=Nom|Number=Sing|Number[psor]=Sing|Person[psor]=3	
4.	4.	ADJ	Case=Nom|NumType=Ord|Number=Sing	
részben	rész	NOUN	Case=Ine|Number=Sing	
.	.	PUNCT	_	

