Vállalkozási	Vállalkozási	PROPN	Case=Nom|Number=Sing	
szerződés	szerződés	NOUN	Case=Nom|Number=Sing	
a	a	DET	Definite=Def|PronType=Art	
„	„	PUNCT	_	
Nádudvar	nádudvar	NOUN	Case=Nom|Number=Sing	
település	település	NOUN	Case=Nom|Number=Sing	
szennyvízelvezető	szennyvízelvezető	ADJ	Case=Nom|Degree=Pos|Number=Sing	
rendszerének	rendszer	NOUN	Case=Gen|Number=Sing|Number[psor]=Sing|Person[psor]=3	
,	,	PUNCT	_	
valamint	valamint	CONJ	_	
szennyvíz	szennyvíz	NOUN	Case=Nom|Number=Sing	
tisztító	tisztító	ADJ	Case=Nom|Degree=Pos|Number=Sing|VerbForm=PartPres	
telepének	telep	NOUN	Case=Gen|Number=Sing|Number[psor]=Sing|Person[psor]=3	
fejlesztése	fejlesztés	NOUN	Case=Nom|Number=Sing|Number[psor]=Sing|Person[psor]=3	
"	"	PUNCT	_	
című	című	ADJ	Case=Nom|Degree=Pos|Number=Sing	
,	,	PUNCT	_	
EU-támogatással	EU-támogatás	NOUN	Case=Ins|Number=Sing	
megvalósítani	megvalósít	VERB	VerbForm=Inf|Voice=Act	
tervezett	tervezett	ADJ	Case=Nom|Degree=Pos|Number=Sing|VerbForm=PartPast	
Projekt	Projekt	PROPN	Case=Nom|Number=Sing	
keretén	keret	NOUN	Case=Sup|Number=Sing|Number[psor]=Sing|Person[psor]=3	
belül	belül	ADP	_	
„	„	PUNCT	_	
a	a	DET	Definite=Def|PronType=Art	
szennyvízelvezető	szennyvízelvezető	ADJ	Case=Nom|Degree=Pos|Number=Sing	
rendszer	rendszer	NOUN	Case=Nom|Number=Sing	
fejlesztése	fejlesztés	NOUN	Case=Nom|Number=Sing|Number[psor]=Sing|Person[psor]=3	
"	"	PUNCT	_	
kivitelezési	kivitelezési	ADJ	Case=Nom|Degree=Pos|Number=Sing	
feladatok	feladat	NOUN	Case=Nom|Number=Plur	
ellátására	ellátás	NOUN	Case=Sub|Number=Sing|Number[psor]=Sing|Person[psor]=3	
vonatkozóan	vonatkozó	ADJ	Case=Ess|Degree=Pos|Number=Sing|VerbForm=PartPres	
,	,	PUNCT	_	
a	a	DET	Definite=Def|PronType=Art	
FIDIC	FIDIC	PROPN	Case=Nom|Number=Sing	
Piros	piros	ADJ	Case=Nom|Degree=Pos|Number=Sing	
Könyv	könyv	NOUN	Case=Nom|Number=Sing	
feltételei	feltétel	NOUN	Case=Nom|Number=Plur|Number[psor]=Sing|Person[psor]=3	
szerint	szerint	ADP	_	
KEOP-1	KEOP-1	PROPN	Case=Nom|Number=Sing	
.	.	PUNCT	_	

2.0	2.0	PROPN	Case=Nom|Number=Sing	
/	/	PUNCT	_	
09-11-2011-0035	09-11-2011-0035	PROPN	Case=Nom|Number=Sing	
.	.	PUNCT	_	

