Vállalkozási	Vállalkozási	PROPN	Case=Nom|Number=Sing	
szerződés	szerződés	NOUN	Case=Nom|Number=Sing	
a	a	DET	Definite=Def|PronType=Art	
TÁMOP-5	TÁMOP-5	PROPN	Case=Nom|Number=Sing	
.	.	PUNCT	_	

3	3	NUM	Case=Nom|NumType=Card|Number=Sing	
.	.	PUNCT	_	
8-11	8-11	NUM	Case=Nom|NumType=Card|Number=Sing	
/	/	PUNCT	_	
A1-2012-0001	A1-2012-0001	PROPN	Case=Nom|Number=Sing	
kódszámú	kódszámú	ADJ	Case=Nom|Degree=Pos|Number=Sing	
,	,	PUNCT	_	
„	„	PUNCT	_	
Rehabilitáció	rehabilitáció	NOUN	Case=Nom|Number=Sing	
-	-	PUNCT	_	
Érték	ér	VERB	Definite=Def|Mood=Ind|Number=Plur|Person=3|Tense=Past|VerbForm=Fin|Voice=Act	
-	-	PUNCT	_	
Változás	változás	NOUN	Case=Nom|Number=Sing	
(	(	PUNCT	_	
RÉV	rév	NOUN	Case=Nom|Number=Sing	
)	)	PUNCT	_	
:	:	PUNCT	_	
Megváltozott	megváltozik	VERB	Definite=Ind|Mood=Ind|Number=Sing|Person=3|Tense=Past|VerbForm=Fin|Voice=Act	
munkaképességű	munkaképességű	ADJ	Case=Nom|Degree=Pos|Number=Sing	
személyek	személy	NOUN	Case=Nom|Number=Plur	
munkaerő-piaci	munkaerő-piaci	ADJ	Case=Nom|Degree=Pos|Number=Sing	
helyzetének	helyzet	NOUN	Case=Gen|Number=Sing|Number[psor]=Sing|Person[psor]=3	
elősegítése	elősegítés	NOUN	Case=Nom|Number=Sing|Number[psor]=Sing|Person[psor]=3	
érdekében	érdek	NOUN	Case=Ine|Number=Sing|Number[psor]=Sing|Person[psor]=3	
történő	történő	ADJ	Case=Nom|Degree=Pos|Number=Sing|VerbForm=PartPres	
rendszerszintű	rendszerszintű	ADJ	Case=Nom|Degree=Pos|Number=Sing	
képzési	képzési	ADJ	Case=Nom|Degree=Pos|Number=Sing	
és	és	CONJ	_	
szolgáltatásfejlesztési	szolgáltatásfejlesztési	ADJ	Case=Nom|Degree=Pos|Number=Sing	
modellprogram	modellprogram	NOUN	Case=Nom|Number=Sing	
"	"	PUNCT	_	
című	című	ADJ	Case=Nom|Degree=Pos|Number=Sing	
kiemelt	kiemelt	ADJ	Case=Nom|Degree=Pos|Number=Sing|VerbForm=PartPast	
projekt	projekt	NOUN	Case=Nom|Number=Sing	
keretében	keret	NOUN	Case=Ine|Number=Sing|Number[psor]=Sing|Person[psor]=3	
a	a	DET	Definite=Def|PronType=Art	
megváltozott	megváltozott	ADJ	Case=Nom|Degree=Pos|Number=Sing|VerbForm=PartPast	
munkaképességű	munkaképességű	ADJ	Case=Nom|Degree=Pos|Number=Sing	
személyek	személy	NOUN	Case=Nom|Number=Plur	
tranzitálását	tranzitálás	NOUN	Case=Acc|Number=Sing|Number[psor]=Sing|Person[psor]=3	
elősegítő	elősegítő	ADJ	Case=Nom|Degree=Pos|Number=Sing|VerbForm=PartPres	
módszertani	módszertani	ADJ	Case=Nom|Degree=Pos|Number=Sing	
eszköztár	eszköztár	NOUN	Case=Nom|Number=Sing	
bővítése	bővítés	NOUN	Case=Nom|Number=Sing|Number[psor]=Sing|Person[psor]=3	
a	a	DET	Definite=Def|PronType=Art	
hálózat	hálózat	NOUN	Case=Nom|Number=Sing	
tagjai	tag	NOUN	Case=Nom|Number=Plur|Number[psor]=Sing|Person[psor]=3	
számára	számára	ADP	_	
gyakorlatorientált	gyakorlatorientált	ADJ	Case=Nom|Degree=Pos|Number=Sing|VerbForm=PartPast	
kézikönyvek	kézikönyv	NOUN	Case=Nom|Number=Plur	
kidolgozásával	kidolgozás	NOUN	Case=Ins|Number=Sing|Number[psor]=Sing|Person[psor]=3	
tárgyában	tárgy	NOUN	Case=Ine|Number=Sing|Number[psor]=Sing|Person[psor]=3	
.	.	PUNCT	_	

