Adásvételi	adásvételi	ADJ	Case=Nom|Degree=Pos|Number=Sing	
szerződés	szerződés	NOUN	Case=Nom|Number=Sing	
keretében	keret	NOUN	Case=Ine|Number=Sing|Number[psor]=Sing|Person[psor]=3	
a	a	DET	Definite=Def|PronType=Art	
szigetszentmiklósi	szigetszentmiklósi	ADJ	Case=Nom|Degree=Pos|Number=Sing	
Szakorvosi	szakorvosi	ADJ	Case=Nom|Degree=Pos|Number=Sing	
Rendelőintézet	rendelőintézet	NOUN	Case=Nom|Number=Sing	
részére	részére	ADP	_	
.	.	PUNCT	_	

1.	1.	ADJ	Case=Nom|NumType=Ord|Number=Sing	
rész	rész	NOUN	Case=Nom|Number=Sing	
:	:	PUNCT	_	
laboratóriumi	laboratóriumi	ADJ	Case=Nom|Degree=Pos|Number=Sing	
vegyszerek	vegyszer	NOUN	Case=Nom|Number=Plur	
beszerzése	beszerzés	NOUN	Case=Nom|Number=Sing|Number[psor]=Sing|Person[psor]=3	
a	a	DET	Definite=Def|PronType=Art	
szükséges	szükséges	ADJ	Case=Nom|Degree=Pos|Number=Sing	
labordiagnosztikai	labordiagnosztikai	ADJ	Case=Nom|Degree=Pos|Number=Sing	
készülékek	készülék	NOUN	Case=Nom|Number=Plur	
térítésmentes	térítésmentes	ADJ	Case=Nom|Degree=Pos|Number=Sing	
használatba	használat	NOUN	Case=Ill|Number=Sing	
adásával	adás	NOUN	Case=Ins|Number=Sing|Number[psor]=Sing|Person[psor]=3	
.	.	PUNCT	_	

2.	2.	ADJ	Case=Nom|NumType=Ord|Number=Sing	
rész	rész	NOUN	Case=Nom|Number=Sing	
:	:	PUNCT	_	
Zárt	zárt	ADJ	Case=Nom|Degree=Pos|Number=Sing|VerbForm=PartPast	
vérvételi	vérvételi	ADJ	Case=Nom|Degree=Pos|Number=Sing	
rendszer	rendszer	NOUN	Case=Nom|Number=Sing	
szállítása	szállítás	NOUN	Case=Nom|Number=Sing|Number[psor]=Sing|Person[psor]=3	
.	.	PUNCT	_	

