Vállalkozási	Vállalkozási	PROPN	Case=Nom|Number=Sing	
szerződés	szerződés	NOUN	Case=Nom|Number=Sing	
keretében	keret	NOUN	Case=Ine|Number=Sing|Number[psor]=Sing|Person[psor]=3	
elektronikus	elektronikus	ADJ	Case=Nom|Degree=Pos|Number=Sing	
fizetési	fizetési	ADJ	Case=Nom|Degree=Pos|Number=Sing	
szolgáltatások	szolgáltatás	NOUN	Case=Nom|Number=Plur	
továbbfejlesztése	továbbfejlesztés	NOUN	Case=Nom|Number=Sing|Number[psor]=Sing|Person[psor]=3	
a	a	DET	Definite=Def|PronType=Art	
KÖFOP-1	KÖFOP-1	PROPN	Case=Nom|Number=Sing	
.	.	PUNCT	_	

0.0	0.0	PROPN	Case=Nom|Number=Sing	
-	-	PUNCT	_	
VEKOP-15-2016-00028	VEKOP-15-2016-00028	PROPN	Case=Nom|Number=Sing	
projekt	projekt	NOUN	Case=Nom|Number=Sing	
keretében	keret	NOUN	Case=Ine|Number=Sing|Number[psor]=Sing|Person[psor]=3	
.	.	PUNCT	_	

Ezen	ezen	PRON	Case=Nom|Number=Sing|Person=3|PronType=Dem	
továbbfejlesztés	továbbfejlesztés	NOUN	Case=Nom|Number=Sing	
középpontjában	középpont	NOUN	Case=Ine|Number=Sing|Number[psor]=Sing|Person[psor]=3	
az	az	DET	Definite=Def|PronType=Art	
„	„	PUNCT	_	
Elektronikus	elektronikus	ADJ	Case=Nom|Degree=Pos|Number=Sing	
fizetési	fizetési	ADJ	Case=Nom|Degree=Pos|Number=Sing	
és	és	CONJ	_	
elszámolási	elszámolási	ADJ	Case=Nom|Degree=Pos|Number=Sing	
rendszer	rendszer	NOUN	Case=Nom|Number=Sing	
"	"	PUNCT	_	
(	(	PUNCT	_	
EFER	EFER	PROPN	Case=Nom|Number=Sing	
)	)	PUNCT	_	
Szabályozott	szabályoz	VERB	Definite=Ind|Mood=Ind|Number=Sing|Person=3|Tense=Past|VerbForm=Fin|Voice=Act	
Elektronikus	Elektronikus	PROPN	Case=Nom|Number=Sing	
Ügyintézési	ügyintézési	ADJ	Case=Nom|Degree=Pos|Number=Sing	
Szolgáltatás	szolgáltatás	NOUN	Case=Nom|Number=Sing	
(	(	PUNCT	_	
SZEÜSZ	SZEÜSZ	PROPN	Case=Nom|Number=Sing	
)	)	PUNCT	_	
által	által	ADP	_	
nyújtott	nyújtott	ADJ	Case=Nom|Degree=Pos|Number=Sing|VerbForm=PartPast	
szolgáltatások	szolgáltatás	NOUN	Case=Nom|Number=Plur	
igénybevételének	igénybevétel	NOUN	Case=Gen|Number=Sing|Number[psor]=Sing|Person[psor]=3	
interfészkapcsolat	interfészkapcsolat	NOUN	Case=Nom|Number=Sing	
útján	útján	ADP	_	
történő	történő	ADJ	Case=Nom|Degree=Pos|Number=Sing|VerbForm=PartPres	
teljes	teljes	ADJ	Case=Nom|Degree=Pos|Number=Sing	
körű	körű	ADJ	Case=Nom|Degree=Pos|Number=Sing	
megvalósítása	megvalósítás	NOUN	Case=Nom|Number=Sing|Number[psor]=Sing|Person[psor]=3	
,	,	PUNCT	_	
a	a	DET	Definite=Def|PronType=Art	
rendőrségi	rendőrségi	ADJ	Case=Nom|Degree=Pos|Number=Sing	
hatósági	hatósági	ADJ	Case=Nom|Degree=Pos|Number=Sing	
ügyfeldolgozást	ügyfeldolgozás	NOUN	Case=Acc|Number=Sing	
biztosító	biztosító	ADJ	Case=Nom|Degree=Pos|Number=Sing|VerbForm=PartPres	
informatikai	informatikai	ADJ	Case=Nom|Degree=Pos|Number=Sing	
szakrendszereibe	szakrendszer	NOUN	Case=Ill|Number=Plur|Number[psor]=Sing|Person[psor]=3	
történő	történő	ADJ	Case=Nom|Degree=Pos|Number=Sing|VerbForm=PartPres	
implementálása	implementálás	NOUN	Case=Nom|Number=Sing|Number[psor]=Sing|Person[psor]=3	
áll	áll	VERB	Definite=Ind|Mood=Ind|Number=Sing|Person=3|Tense=Pres|VerbForm=Fin|Voice=Act	
.	.	PUNCT	_	

A	a	DET	Definite=Def|PronType=Art	
fenti	fenti	ADJ	Case=Nom|Degree=Pos|Number=Sing	
funkciók	funkció	NOUN	Case=Nom|Number=Plur	
megvalósítása	megvalósítás	NOUN	Case=Nom|Number=Sing|Number[psor]=Sing|Person[psor]=3	
érdekében	érdek	NOUN	Case=Ine|Number=Sing|Number[psor]=Sing|Person[psor]=3	
jelen	jelen	ADJ	Case=Nom|Degree=Pos|Number=Sing	
közbeszerzés	közbeszerzés	NOUN	Case=Nom|Number=Sing	
tárgyát	tárgy	NOUN	Case=Acc|Number=Sing|Number[psor]=Sing|Person[psor]=3	
képező	képező	ADJ	Case=Nom|Degree=Pos|Number=Sing|VerbForm=PartPres	
szoftverfejlesztés	szoftverfejlesztés	NOUN	Case=Nom|Number=Sing	
által	által	ADP	_	
elektronikus	elektronikus	ADJ	Case=Nom|Degree=Pos|Number=Sing	
fizetési	fizetési	ADJ	Case=Nom|Degree=Pos|Number=Sing	
megoldások	megoldás	NOUN	Case=Nom|Number=Plur	
kerülnek	kerül	VERB	Definite=Ind|Mood=Ind|Number=Plur|Person=3|Tense=Pres|VerbForm=Fin|Voice=Act	
megvalósításra	megvalósítás	NOUN	Case=Sub|Number=Sing	
,	,	PUNCT	_	
amely	amely	PRON	Case=Nom|Number=Sing|Person=3|PronType=Rel	
integrálásra	integrálás	NOUN	Case=Sub|Number=Sing	
kerül	kerül	VERB	Definite=Ind|Mood=Ind|Number=Sing|Person=3|Tense=Pres|VerbForm=Fin|Voice=Act	
a	a	DET	Definite=Def|PronType=Art	
Rendőrség	rendőrség	NOUN	Case=Nom|Number=Sing	
ügyviteli	ügyviteli	ADJ	Case=Nom|Degree=Pos|Number=Sing	
,	,	PUNCT	_	
valamint	valamint	CONJ	_	
a	a	DET	Definite=Def|PronType=Art	
követelésállomány	követelésállomány	NOUN	Case=Nom|Number=Sing	
nyilvántartást	nyilvántartás	NOUN	Case=Acc|Number=Sing	
és	és	CONJ	_	
a	a	DET	Definite=Def|PronType=Art	
hatósági	hatósági	ADJ	Case=Nom|Degree=Pos|Number=Sing	
ügyfeldolgozást	ügyfeldolgozás	NOUN	Case=Acc|Number=Sing	
támogató	támogató	ADJ	Case=Nom|Degree=Pos|Number=Sing|VerbForm=PartPres	
pénzügyi	pénzügyi	ADJ	Case=Nom|Degree=Pos|Number=Sing	
szakrendszeréhez	szakrendszer	NOUN	Case=All|Number=Sing|Number[psor]=Sing|Person[psor]=3	
.	.	PUNCT	_	

A	a	DET	Definite=Def|PronType=Art	
projekt	projekt	NOUN	Case=Nom|Number=Sing	
keretében	keret	NOUN	Case=Ine|Number=Sing|Number[psor]=Sing|Person[psor]=3	
bevezetésre	bevezetés	NOUN	Case=Sub|Number=Sing	
kerülő	kerülő	ADJ	Case=Nom|Degree=Pos|Number=Sing|VerbForm=PartPres	
rendszer	rendszer	NOUN	Case=Nom|Number=Sing	
az	az	DET	Definite=Def|PronType=Art	
állampolgárok	állampolgár	NOUN	Case=Nom|Number=Plur	
számára	számára	ADP	_	
biztosítja	biztosít	VERB	Definite=Def|Mood=Ind|Number=Sing|Person=3|Tense=Pres|VerbForm=Fin|Voice=Act	
a	a	DET	Definite=Def|PronType=Art	
bírságok	bírság	NOUN	Case=Nom|Number=Plur	
helyszíni	helyszíni	ADJ	Case=Nom|Degree=Pos|Number=Sing	
,	,	PUNCT	_	
bankkártyával	bankkártya	NOUN	Case=Ins|Number=Sing	
történő	történő	ADJ	Case=Nom|Degree=Pos|Number=Sing|VerbForm=PartPres	
befizetésének	befizetés	NOUN	Case=Gen|Number=Sing|Number[psor]=Sing|Person[psor]=3	
a	a	DET	Definite=Def|PronType=Art	
lehetőségét	lehetőség	NOUN	Case=Acc|Number=Sing|Number[psor]=Sing|Person[psor]=3	
.	.	PUNCT	_	

