A	a	DET	Definite=Def|PronType=Art	
jelen	jelen	ADJ	Case=Nom|Degree=Pos|Number=Sing	
közbeszerzési	közbeszerzési	ADJ	Case=Nom|Degree=Pos|Number=Sing	
eljárás	eljárás	NOUN	Case=Nom|Number=Sing	
célja	cél	NOUN	Case=Nom|Number=Sing|Number[psor]=Sing|Person[psor]=3	
,	,	PUNCT	_	
hogy	hogy	SCONJ	_	
az	az	DET	Definite=Def|PronType=Art	
MVMI	MVMI	ADJ	Case=Nom|Degree=Pos|Number=Sing	
Zrt.	Zrt.	PROPN	Case=Nom|Number=Sing	
Treasury	Treasury	PROPN	Case=Nom|Number=Sing	
rendszerével	rendszer	NOUN	Case=Ins|Number=Sing|Number[psor]=Sing|Person[psor]=3	
kapcsolatosan	kapcsolatos	ADJ	Case=Ess|Degree=Pos|Number=Sing	
felmerülő	felmerülő	ADJ	Case=Nom|Degree=Pos|Number=Sing|VerbForm=PartPres	
üzleti	üzleti	ADJ	Case=Nom|Degree=Pos|Number=Sing	
igények	igény	NOUN	Case=Nom|Number=Plur	
(	(	PUNCT	_	
új	új	ADJ	Case=Nom|Degree=Pos|Number=Sing	
funkciók	funkció	NOUN	Case=Nom|Number=Plur	
,	,	PUNCT	_	
folyamatok	folyamat	NOUN	Case=Nom|Number=Plur	
,	,	PUNCT	_	
meglévő	meglévő	ADJ	Case=Nom|Degree=Pos|Number=Sing|VerbForm=PartPres	
funkciók	funkció	NOUN	Case=Nom|Number=Plur	
,	,	PUNCT	_	
folyamatok	folyamat	NOUN	Case=Nom|Number=Plur	
módosítása	módosítás	NOUN	Case=Nom|Number=Sing|Number[psor]=Sing|Person[psor]=3	
)	)	PUNCT	_	
megvalósítását	megvalósítás	NOUN	Case=Acc|Number=Sing|Number[psor]=Sing|Person[psor]=3	
a	a	DET	Definite=Def|PronType=Art	
jelen	jelen	ADJ	Case=Nom|Degree=Pos|Number=Sing	
eljárás	eljárás	NOUN	Case=Nom|Number=Sing	
során	sor	NOUN	Case=Sup|Number=Sing|Number[psor]=Sing|Person[psor]=3	
nyertes	nyertes	ADJ	Case=Nom|Degree=Pos|Number=Sing	
Ajánlattevővel	ajánlattevő	NOUN	Case=Ins|Number=Sing	
kötött	kötött	ADJ	Case=Nom|Degree=Pos|Number=Sing|VerbForm=PartPast	
Keretmegállapodás	keretmegállapodás	NOUN	Case=Nom|Number=Sing	
keretében	keret	NOUN	Case=Ine|Number=Sing|Number[psor]=Sing|Person[psor]=3	
a	a	DET	Definite=Def|PronType=Art	
nyertes	nyertes	ADJ	Case=Nom|Degree=Pos|Number=Sing	
Ajánlattevő	ajánlattevő	NOUN	Case=Nom|Number=Sing	
közreműködésével	közreműködés	NOUN	Case=Ins|Number=Sing|Number[psor]=Sing|Person[psor]=3	
végrehajtsa	végrehajt	VERB	Definite=Def|Mood=Imp|Number=Sing|Person=3|Tense=Pres|VerbForm=Fin|Voice=Act	
.	.	PUNCT	_	

Ajánlattevőnek	ajánlattevő	NOUN	Case=Dat|Number=Sing	
az	az	DET	Definite=Def|PronType=Art	
alább	alá	ADV	Degree=Cmp	
részletezett	részletezett	ADJ	Case=Nom|Degree=Pos|Number=Sing|VerbForm=PartPast	
szolgáltatásokat	szolgáltatás	NOUN	Case=Acc|Number=Plur	
kell	kell	VERB	Definite=Ind|Mood=Ind|Number=Sing|Person=3|Tense=Pres|VerbForm=Fin|Voice=Act	
nyújtania	nyújt	VERB	Number=Sing|Person=3|Tense=Pres|VerbForm=Inf|Voice=Act	
a	a	DET	Definite=Def|PronType=Art	
keretmegállapodás	keretmegállapodás	NOUN	Case=Nom|Number=Sing	
időtartama	időtartam	NOUN	Case=Nom|Number=Sing|Number[psor]=Sing|Person[psor]=3	
alatt	alatt	ADP	_	
megrendelések	megrendelés	NOUN	Case=Nom|Number=Plur	
alapján	alap	NOUN	Case=Sup|Number=Sing|Number[psor]=Sing|Person[psor]=3	
:	:	PUNCT	_	
-	-	PUNCT	_	
Inforex	inforex	NOUN	Case=Nom|Number=Sing	
rendszerekkel	rendszer	NOUN	Case=Ins|Number=Plur	
kapcsolatos	kapcsolatos	ADJ	Case=Nom|Degree=Pos|Number=Sing	
fejlesztések	fejlesztés	NOUN	Case=Nom|Number=Plur	
,	,	PUNCT	_	
módosítások	módosítás	NOUN	Case=Nom|Number=Plur	
megvalósítása	megvalósítás	NOUN	Case=Nom|Number=Sing|Number[psor]=Sing|Person[psor]=3	
eseti	eseti	ADJ	Case=Nom|Degree=Pos|Number=Sing	
,	,	PUNCT	_	
feladatonkénti	feladatonkénti	NOUN	Case=Dis|Number=Sing	
lehívás	lehívás	NOUN	Case=Nom|Number=Sing	
és	és	CONJ	_	
erőforrás	erőforrás	NOUN	Case=Nom|Number=Sing	
elszámolás	elszámolás	NOUN	Case=Nom|Number=Sing	
alapján	alap	NOUN	Case=Sup|Number=Sing|Number[psor]=Sing|Person[psor]=3	
,	,	PUNCT	_	
-	-	PUNCT	_	
Az	az	DET	Definite=Def|PronType=Art	
egyes	egyes	ADJ	Case=Nom|Degree=Pos|Number=Sing	
fejlesztések	fejlesztés	NOUN	Case=Nom|Number=Plur	
elvégzését	elvégzés	NOUN	Case=Acc|Number=Sing|Number[psor]=Sing|Person[psor]=3	
követően	követő	ADJ	Case=Ess|Degree=Pos|Number=Sing|VerbForm=PartPres	
az	az	DET	Definite=Def|PronType=Art	
új	új	ADJ	Case=Nom|Degree=Pos|Number=Sing	
modulok	modul	NOUN	Case=Nom|Number=Plur	
használatával	használat	NOUN	Case=Ins|Number=Sing|Number[psor]=Sing|Person[psor]=3	
kapcsolatos	kapcsolatos	ADJ	Case=Nom|Degree=Pos|Number=Sing	
oktatások	oktatás	NOUN	Case=Nom|Number=Plur	
a	a	DET	Definite=Def|PronType=Art	
fejlesztés	fejlesztés	NOUN	Case=Nom|Number=Sing	
jellegétől	jelleg	NOUN	Case=Abl|Number=Sing|Number[psor]=Sing|Person[psor]=3	
függően	függő	ADJ	Case=Ess|Degree=Pos|Number=Sing|VerbForm=PartPres	
4	4	NUM	Case=Nom|NumType=Card|Number=Sing	
óra	óra	NOUN	Case=Nom|Number=Sing	
és	és	CONJ	_	
10	10	NUM	Case=Nom|NumType=Card|Number=Sing	
nap	nap	NOUN	Case=Nom|Number=Sing	
közötti	közötti	ADJ	Case=Nom|Degree=Pos|Number=Sing	
időtartamban	időtartam	NOUN	Case=Ine|Number=Sing	
,	,	PUNCT	_	
2-20	2-20	NUM	Case=Nom|NumType=Card|Number=Sing	
fős	fős	ADJ	Case=Nom|Degree=Pos|Number=Sing	
csoportokban	csoport	NOUN	Case=Ine|Number=Plur	
.	.	PUNCT	_	

