Egészségügyi	Egészségügyi	PROPN	Case=Nom|Number=Sing	
szimulációs	szimulációs	ADJ	Case=Nom|Degree=Pos|Number=Sing	
eszközök	eszköz	NOUN	Case=Nom|Number=Plur	
beszerzése	beszerzés	NOUN	Case=Nom|Number=Sing|Number[psor]=Sing|Person[psor]=3	
a	a	DET	Definite=Def|PronType=Art	
Pécsi	Pécsi	PROPN	Case=Nom|Number=Sing	
Tudományegyetem	Tudományegyetem	PROPN	Case=Nom|Number=Sing	
EFOP-4	EFOP-4	PROPN	Case=Nom|Number=Sing	
.	.	PUNCT	_	

2	2	NUM	Case=Nom|NumType=Card|Number=Sing	
.	.	PUNCT	_	
1-16-2017-00008	1-16-2017-00008	PROPN	Case=Nom|Number=Sing	
jelű	jelű	ADJ	Case=Nom|Degree=Pos|Number=Sing	
pályázaton	pályázat	NOUN	Case=Sup|Number=Sing	
belül	belül	ADP	_	
az	az	DET	Definite=Def|PronType=Art	
ETK	ETK	PROPN	Case=Nom|Number=Sing	
Humán	humán	ADJ	Case=Nom|Degree=Pos|Number=Sing	
Szimulációs	szimulációs	ADJ	Case=Nom|Degree=Pos|Number=Sing	
Központ	Központ	PROPN	Case=Nom|Number=Sing	
fejlesztésére	fejlesztés	NOUN	Case=Sub|Number=Sing|Number[psor]=Sing|Person[psor]=3	
a	a	DET	Definite=Def|PronType=Art	
közbeszerzési	közbeszerzési	ADJ	Case=Nom|Degree=Pos|Number=Sing	
dokumentációban	dokumentáció	NOUN	Case=Ine|Number=Sing	
meghatározott	meghatározott	ADJ	Case=Nom|Degree=Pos|Number=Sing|VerbForm=PartPast	
paraméterekkel	paraméter	NOUN	Case=Ins|Number=Plur	
4	4	NUM	Case=Nom|NumType=Card|Number=Sing	
ajánlati	ajánlati	ADJ	Case=Nom|Degree=Pos|Number=Sing	
részben	rész	NOUN	Case=Ine|Number=Sing	
.	.	PUNCT	_	

