Megbízási	megbízási	ADJ	Case=Nom|Degree=Pos|Number=Sing	
szerződés	szerződés	NOUN	Case=Nom|Number=Sing	
az	az	DET	Definite=Def|PronType=Art	
Extreme	Extreme	PROPN	Case=Nom|Number=Sing	
Light	light	NOUN	Case=Nom|Number=Sing	
Infrastructure	Infrastructure	PROPN	Case=Nom|Number=Sing	
Attosecond	Attosecond	X	_	
Light	light	NOUN	Case=Nom|Number=Sing	
Pulse	puls	NOUN	Case=Nom|Number=Sing|Number[psor]=Sing|Person[psor]=3	
Source	Source	PROPN	Case=Nom|Number=Sing	
(	(	PUNCT	_	
ELI-ALPS	ELI-ALPS	PROPN	Case=Nom|Number=Sing	
)	)	PUNCT	_	
kutatási	kutatási	ADJ	Case=Nom|Degree=Pos|Number=Sing	
nagyberendezésnek	nagyberendezés	NOUN	Case=Dat|Number=Sing	
helyet	hely	NOUN	Case=Acc|Number=Sing	
adó	adó	ADJ	Case=Nom|Degree=Pos|Number=Sing|VerbForm=PartPres	
és	és	CONJ	_	
az	az	DET	Definite=Def|PronType=Art	
Új	új	ADJ	Case=Nom|Degree=Pos|Number=Sing	
Széchenyi	Széchenyi	PROPN	Case=Nom|Number=Sing	
Terv	Terv	PROPN	Case=Nom|Number=Sing	
keretében	keret	NOUN	Case=Ine|Number=Sing|Number[psor]=Sing|Person[psor]=3	
megvalósuló	megvalósuló	ADJ	Case=Nom|Degree=Pos|Number=Sing|VerbForm=PartPres	
kutatóközpont	kutatóközpont	NOUN	Case=Nom|Number=Sing	
,	,	PUNCT	_	
valamint	valamint	CONJ	_	
a	a	DET	Definite=Def|PronType=Art	
beruházással	beruházás	NOUN	Case=Ins|Number=Sing	
érintett	érintett	ADJ	Case=Nom|Degree=Pos|Number=Sing|VerbForm=PartPast	
telkeken	telek	NOUN	Case=Sup|Number=Plur	
belüli	belüli	ADJ	Case=Nom|Degree=Pos|Number=Sing	
és	és	CONJ	_	
kívüli	kívüli	ADJ	Case=Nom|Degree=Pos|Number=Sing	
közműhálózat	közműhálózat	NOUN	Case=Nom|Number=Sing	
és	és	CONJ	_	
belső	belső	ADJ	Case=Nom|Degree=Pos|Number=Sing	
úthálózat	úthálózat	NOUN	Case=Nom|Number=Sing	
építési	építési	ADJ	Case=Nom|Degree=Pos|Number=Sing	
-	-	PUNCT	_	
kivitelezési	kivitelezési	ADJ	Case=Nom|Degree=Pos|Number=Sing	
munkáinak	munka	NOUN	Case=Gen|Number=Plur|Number[psor]=Sing|Person[psor]=3	
191	191	NUM	Case=Nom|NumType=Card|Number=Sing	
/	/	PUNCT	_	
2009.	2009.	ADJ	Case=Nom|NumType=Ord|Number=Sing	

(	(	PUNCT	_	
IX	9	NUM	Case=Nom|NumType=Card|Number=Sing	
.	.	PUNCT	_	

15.	15.	ADJ	Case=Nom|NumType=Ord|Number=Sing	
)	)	PUNCT	_	

Korm	Korm	PROPN	Case=Nom|Number=Sing	
.	.	PUNCT	_	
rendelet	rendelet	NOUN	Case=Nom|Number=Sing	
szerinti	szerinti	ADJ	Case=Nom|Degree=Pos|Number=Sing	
építési	építési	ADJ	Case=Nom|Degree=Pos|Number=Sing	
műszaki	műszaki	ADJ	Case=Nom|Degree=Pos|Number=Sing	
ellenőri	ellenőri	ADJ	Case=Nom|Degree=Pos|Number=Sing	
és	és	CONJ	_	
egyéb	egyéb	PRON	Case=Nom|Number=Sing|Person=3|PronType=Ind	
műszaki	műszaki	ADJ	Case=Nom|Degree=Pos|Number=Sing	
tanácsadási	tanácsadási	ADJ	Case=Nom|Degree=Pos|Number=Sing	
feladatok	feladat	NOUN	Case=Nom|Number=Plur	
ellátására	ellátás	NOUN	Case=Sub|Number=Sing|Number[psor]=Sing|Person[psor]=3	
.	.	PUNCT	_	

