Vállalkozási	Vállalkozási	PROPN	Case=Nom|Number=Sing	
szerződés	szerződés	NOUN	Case=Nom|Number=Sing	
az	az	DET	Definite=Def|PronType=Art	
M0	M0	PROPN	Case=Nom|Number=Sing	
autóút	autóút	NOUN	Case=Nom|Number=Sing	
déli	déli	ADJ	Case=Nom|Degree=Pos|Number=Sing	
szektorán	szektor	NOUN	Case=Sup|Number=Sing|Number[psor]=Sing|Person[psor]=3	
a	a	DET	Definite=Def|PronType=Art	
0+115-2+840	0+115-2+840	PROPN	Case=Nom|Number=Sing	
km	km	NOUN	Case=Nom|Number=Sing	
sz.	sz.	ADJ	Case=Nom|Degree=Pos|Number=Sing	
között	között	ADP	_	
2x3	2x3	PROPN	Case=Nom|Number=Sing	
sávra	sáv	NOUN	Case=Sub|Number=Sing	
történő	történő	ADJ	Case=Nom|Degree=Pos|Number=Sing|VerbForm=PartPres	
bővítéséhez	bővítés	NOUN	Case=All|Number=Sing|Number[psor]=Sing|Person[psor]=3	
bal	bal	ADJ	Case=Nom|Degree=Pos|Number=Sing	
pálya	pálya	NOUN	Case=Nom|Number=Sing	
építése	építés	NOUN	Case=Nom|Number=Sing|Number[psor]=Sing|Person[psor]=3	
során	sor	NOUN	Case=Sup|Number=Sing|Number[psor]=Sing|Person[psor]=3	
építés	építés	NOUN	Case=Nom|Number=Sing	
,	,	PUNCT	_	
meglévő	meglévő	ADJ	Case=Nom|Degree=Pos|Number=Sing|VerbForm=PartPres	
jobb	jobb	ADJ	Case=Nom|Degree=Pos|Number=Sing	
pálya	pálya	NOUN	Case=Nom|Number=Sing	
0+220-3+225	0+220-3+225	PROPN	Case=Nom|Number=Sing	
km	km	NOUN	Case=Nom|Number=Sing	
sz.	sz.	NOUN	Case=Nom|Number=Sing	
közötti	közötti	ADJ	Case=Nom|Degree=Pos|Number=Sing	
részének	rész	NOUN	Case=Gen|Number=Sing|Number[psor]=Sing|Person[psor]=3	
forgalomba	forgalom	NOUN	Case=Ill|Number=Sing	
helyezésével	helyezés	NOUN	Case=Ins|Number=Sing|Number[psor]=Sing|Person[psor]=3	
kapcsolatos	kapcsolatos	ADJ	Case=Nom|Degree=Pos|Number=Sing	
építési	építési	ADJ	Case=Nom|Degree=Pos|Number=Sing	
munkák	munka	NOUN	Case=Nom|Number=Plur	
elvégzése	elvégzés	NOUN	Case=Nom|Number=Sing|Number[psor]=Sing|Person[psor]=3	
tárgyában	tárgy	NOUN	Case=Ine|Number=Sing|Number[psor]=Sing|Person[psor]=3	
.	.	PUNCT	_	

