„	„	PUNCT	_	
Általános	általános	ADJ	Case=Nom|Degree=Pos|Number=Sing	
felhasználású	felhasználású	ADJ	Case=Nom|Degree=Pos|Number=Sing	
villamos	villamos	ADJ	Case=Nom|Degree=Pos|Number=Sing	
energia	energia	NOUN	Case=Nom|Number=Sing	
értékesítése	értékesítés	NOUN	Case=Nom|Number=Sing|Number[psor]=Sing|Person[psor]=3	
teljes	teljes	ADJ	Case=Nom|Degree=Pos|Number=Sing	
ellátás	ellátás	NOUN	Case=Nom|Number=Sing	
alapú	alapú	ADJ	Case=Nom|Degree=Pos|Number=Sing	
villamos	villamos	ADJ	Case=Nom|Degree=Pos|Number=Sing	
energia	energia	NOUN	Case=Nom|Number=Sing	
kereskedelmi	kereskedelmi	ADJ	Case=Nom|Degree=Pos|Number=Sing	
szerződés	szerződés	NOUN	Case=Nom|Number=Sing	
keretében	keret	NOUN	Case=Ine|Number=Sing|Number[psor]=Sing|Person[psor]=3	
a	a	DET	Definite=Def|PronType=Art	
Hírös	hírös	NOUN	Case=Nom|Number=Sing	
Sport	Sport	PROPN	Case=Nom|Number=Sing	
Nonprofit	nonprofit	ADJ	Case=Nom|Degree=Pos|Number=Sing	
Kft.	kft.	NOUN	Case=Nom|Number=Sing	
részére	részére	ADP	_	
"	"	PUNCT	_	

