Vállalkozási	Vállalkozási	PROPN	Case=Nom|Number=Sing	
keretszerződés	keretszerződés	NOUN	Case=Nom|Number=Sing	
a	a	DET	Definite=Def|PronType=Art	
Megrendelő	megrendelő	NOUN	Case=Nom|Number=Sing	
Szeged	Szeged	PROPN	Case=Nom|Number=Sing	
,	,	PUNCT	_	
Sándorfalvi	sándorfalvi	NOUN	Case=Nom|Number=Sing	
úti	úti	ADJ	Case=Nom|Degree=Pos|Number=Sing	
Regionális	Regionális	PROPN	Case=Nom|Number=Sing	
Hulladéklerakó	hulladéklerakó	NOUN	Case=Nom|Number=Sing	
Telepén	telep	NOUN	Case=Sup|Number=Sing|Number[psor]=Sing|Person[psor]=3	
különböző	különböző	ADJ	Case=Nom|Degree=Pos|Number=Sing	
hulladékok	hulladék	NOUN	Case=Nom|Number=Plur	
előkezelése	előkezelés	NOUN	Case=Nom|Number=Sing|Number[psor]=Sing|Person[psor]=3	
,	,	PUNCT	_	
osztályozása	osztályozás	NOUN	Case=Nom|Number=Sing|Number[psor]=Sing|Person[psor]=3	
,	,	PUNCT	_	
rakodása	rakodás	NOUN	Case=Nom|Number=Sing|Number[psor]=Sing|Person[psor]=3	
,	,	PUNCT	_	
telephelyen	telephely	NOUN	Case=Sup|Number=Sing	
belüli	belüli	ADJ	Case=Nom|Degree=Pos|Number=Sing	
szállítási	szállítási	ADJ	Case=Nom|Degree=Pos|Number=Sing	
munkák	munka	NOUN	Case=Nom|Number=Plur	
ellátása	ellátás	NOUN	Case=Nom|Number=Sing|Number[psor]=Sing|Person[psor]=3	
tárgyban	tárgy	NOUN	Case=Ine|Number=Sing	
.	.	PUNCT	_	

