Összességében	összesség	NOUN	Case=Ine|Number=Sing|Number[psor]=Sing|Person[psor]=3	
nettó	nettó	ADJ	Case=Nom|Degree=Pos|Number=Sing	
330	330	NUM	Case=Nom|NumType=Card|Number=Sing	
000	000	NUM	Case=Nom|NumType=Card|Number=Sing	
000	000	NUM	Case=Nom|NumType=Card|Number=Sing	
HUF	HUF	PROPN	Case=Nom|Number=Sing	
-	-	PUNCT	_	
30	30	NUM	Case=Nom|NumType=Card|Number=Sing	
%	%	PUNCT	_	
keretösszeg	keretösszeg	NOUN	Case=Nom|Number=Sing	
erejéig	erő	NOUN	Case=Ter|Number=Sing|Number[psor]=Sing|Person[psor]=3	
szállítási	szállítási	ADJ	Case=Nom|Degree=Pos|Number=Sing	
keretszerződés	keretszerződés	NOUN	Case=Nom|Number=Sing	
keretében	keret	NOUN	Case=Ine|Number=Sing|Number[psor]=Sing|Person[psor]=3	
hulladékgyűjtő	hulladékgyűjtő	ADJ	Case=Nom|Degree=Pos|Number=Sing	
felépítményekhez	felépítmény	NOUN	Case=All|Number=Plur	
és	és	CONJ	_	
beürítő	beürítő	ADJ	Case=Nom|Degree=Pos|Number=Sing|VerbForm=PartPres	
szerkezetekhez	szerkezet	NOUN	Case=All|Number=Plur	
gyári	gyári	ADJ	Case=Nom|Degree=Pos|Number=Sing	
új	új	ADJ	Case=Nom|Degree=Pos|Number=Sing	
alkatrészek	alkatrész	NOUN	Case=Nom|Number=Plur	
beszerzése	beszerzés	NOUN	Case=Nom|Number=Sing|Number[psor]=Sing|Person[psor]=3	
és	és	CONJ	_	
szállítása	szállítás	NOUN	Case=Nom|Number=Sing|Number[psor]=Sing|Person[psor]=3	
.	.	PUNCT	_	

