Szerződés	szerződés	NOUN	Case=Nom|Number=Sing	
meghatározása	meghatározás	NOUN	Case=Nom|Number=Sing|Number[psor]=Sing|Person[psor]=3	
:	:	PUNCT	_	
Hitelszerződés	hitelszerződés	NOUN	Case=Nom|Number=Sing	
Pécs	Pécs	PROPN	Case=Nom|Number=Sing	
Megyei	Megyei	PROPN	Case=Nom|Number=Sing	
Jogú	Jogú	PROPN	Case=Nom|Number=Sing	
Város	Város	PROPN	Case=Nom|Number=Sing	
Önkormányzata	Önkormányzata	PROPN	Case=Nom|Number=Sing	
részére	részére	ADP	_	
MFB	MFB	PROPN	Case=Nom|Number=Sing	
Önkormányzati	Önkormányzati	PROPN	Case=Nom|Number=Sing	
Infrastruktúra	infrastruktúra	NOUN	Case=Nom|Number=Sing	
Fejlesztési	Fejlesztési	PROPN	Case=Nom|Number=Sing	
program	program	NOUN	Case=Nom|Number=Sing	
keretében	keret	NOUN	Case=Ine|Number=Sing|Number[psor]=Sing|Person[psor]=3	
fejlesztési	fejlesztési	ADJ	Case=Nom|Degree=Pos|Number=Sing	
célú	célú	ADJ	Case=Nom|Degree=Pos|Number=Sing	
hitel	hitel	NOUN	Case=Nom|Number=Sing	
nyújtása	nyújtás	NOUN	Case=Nom|Number=Sing|Number[psor]=Sing|Person[psor]=3	
.	.	PUNCT	_	

