Különböző	különböző	ADJ	Case=Nom|Degree=Pos|Number=Sing	
betontípusok	betontípus	NOUN	Case=Nom|Number=Plur	
beszerzése	beszerzés	NOUN	Case=Nom|Number=Sing|Number[psor]=Sing|Person[psor]=3	
útépítési	útépítési	ADJ	Case=Nom|Degree=Pos|Number=Sing	
betonalapok	betonalap	NOUN	Case=Nom|Number=Plur	
,	,	PUNCT	_	
valamint	valamint	CONJ	_	
bazaltbeton	bazaltbeton	NOUN	Case=Nom|Number=Sing	
burkolatú	burkolatú	ADJ	Case=Nom|Degree=Pos|Number=Sing	
buszmegállók	buszmegálló	NOUN	Case=Nom|Number=Plur	
kivitelezési	kivitelezési	ADJ	Case=Nom|Degree=Pos|Number=Sing	
munkáinak	munka	NOUN	Case=Gen|Number=Plur|Number[psor]=Sing|Person[psor]=3	
végrehajtásához	végrehajtás	NOUN	Case=All|Number=Sing|Number[psor]=Sing|Person[psor]=3	
,	,	PUNCT	_	
a	a	DET	Definite=Def|PronType=Art	
nagyfelületű	nagyfelületű	ADJ	Case=Nom|Degree=Pos|Number=Sing	
útburkolat-helyreállítási	útburkolat-helyreállítási	ADJ	Case=Nom|Degree=Pos|Number=Sing	
munkák	munka	NOUN	Case=Nom|Number=Plur	
kivitelezéséhez	kivitelezés	NOUN	Case=All|Number=Sing|Number[psor]=Sing|Person[psor]=3	
,	,	PUNCT	_	
illetve	illetve	CONJ	_	
a	a	DET	Definite=Def|PronType=Art	
közszolgáltató	közszolgáltató	NOUN	Case=Nom|Number=Sing	
szerződésen	szerződés	NOUN	Case=Sup|Number=Sing	
belüli	belüli	ADJ	Case=Nom|Degree=Pos|Number=Sing	
fenntartási	fenntartási	ADJ	Case=Nom|Degree=Pos|Number=Sing	
,	,	PUNCT	_	
karbantartási	karbantartási	ADJ	Case=Nom|Degree=Pos|Number=Sing	
és	és	CONJ	_	
felújítási	felújítási	ADJ	Case=Nom|Degree=Pos|Number=Sing	
munkák	munka	NOUN	Case=Nom|Number=Plur	
elvégzéséhez	elvégzés	NOUN	Case=All|Number=Sing|Number[psor]=Sing|Person[psor]=3	
.	.	PUNCT	_	

