A	a	DET	Definite=Def|PronType=Art	
Terror	Terror	PROPN	Case=Nom|Number=Sing	
Háza	Háza	PROPN	Case=Nom|Number=Sing	
Múzeum	Múzeum	PROPN	Case=Nom|Number=Sing	
és	és	CONJ	_	
az	az	DET	Definite=Def|PronType=Art	
előtte	előtt	PRON	Case=Nom|Number=Sing|Person=3|PronType=Prs	
lévő	lévő	ADJ	Case=Nom|Degree=Pos|Number=Sing|VerbForm=PartPres	
két	két	NUM	Case=Nom|NumType=Card|Number=Sing	
műtárgy	műtárgy	NOUN	Case=Nom|Number=Sing	
(	(	PUNCT	_	
vasfüggöny	vasfüggöny	NOUN	Case=Nom|Number=Sing	
emlékmű	emlékmű	NOUN	Case=Nom|Number=Sing	
és	és	CONJ	_	
berlini	berlini	ADJ	Case=Nom|Degree=Pos|Number=Sing	
fal	fal	NOUN	Case=Nom|Number=Sing	
darabja	darab	NOUN	Case=Nom|Number=Sing|Number[psor]=Sing|Person[psor]=3	
)	)	PUNCT	_	
és	és	CONJ	_	
az	az	DET	Definite=Def|PronType=Art	
időszaki	időszaki	ADJ	Case=Nom|Degree=Pos|Number=Sing	
kiállítások	kiállítás	NOUN	Case=Nom|Number=Plur	
24	24	NUM	Case=Nom|NumType=Card|Number=Sing	
órás	órás	ADJ	Case=Nom|Degree=Pos|Number=Sing	
,	,	PUNCT	_	
folyamatos	folyamatos	ADJ	Case=Nom|Degree=Pos|Number=Sing	
őrzés-védelmi	őrzés-védelmi	ADJ	Case=Nom|Degree=Pos|Number=Sing	
feladatainak	feladat	NOUN	Case=Gen|Number=Plur|Number[psor]=Sing|Person[psor]=3	
(	(	PUNCT	_	
portaszolgálat	portaszolgálat	NOUN	Case=Nom|Number=Sing	
és	és	CONJ	_	
élőerős	élőerős	ADJ	Case=Nom|Degree=Pos|Number=Sing	
őrzés-védelmi	őrzés-védelmi	ADJ	Case=Nom|Degree=Pos|Number=Sing	
feladatok	feladat	NOUN	Case=Nom|Number=Plur	
)	)	PUNCT	_	
ellátása	ellátás	NOUN	Case=Nom|Number=Sing|Number[psor]=Sing|Person[psor]=3	
vállalkozási	vállalkozási	ADJ	Case=Nom|Degree=Pos|Number=Sing	
szerződés	szerződés	NOUN	Case=Nom|Number=Sing	
keretében	keret	NOUN	Case=Ine|Number=Sing|Number[psor]=Sing|Person[psor]=3	
.	.	PUNCT	_	

Tekintettel	tekintet	NOUN	Case=Ins|Number=Sing	
arra	az	PRON	Case=Sub|Number=Sing|Person=3|PronType=Dem	
,	,	PUNCT	_	
hogy	hogy	SCONJ	_	
a	a	DET	Definite=Def|PronType=Art	
közbeszerzés	közbeszerzés	NOUN	Case=Nom|Number=Sing	
tárgya	tárgy	NOUN	Case=Nom|Number=Sing|Number[psor]=Sing|Person[psor]=3	
egy	egy	DET	Definite=Ind|PronType=Art	
típusú	típusú	ADJ	Case=Nom|Degree=Pos|Number=Sing	
szolgáltatás	szolgáltatás	NOUN	Case=Nom|Number=Sing	
megrendelése	megrendelés	NOUN	Case=Nom|Number=Sing|Number[psor]=Sing|Person[psor]=3	
,	,	PUNCT	_	
a	a	DET	Definite=Def|PronType=Art	
hatékony	hatékony	ADJ	Case=Nom|Degree=Pos|Number=Sing	
és	és	CONJ	_	
felelős	felelős	ADJ	Case=Nom|Degree=Pos|Number=Sing	
gazdálkodás	gazdálkodás	NOUN	Case=Nom|Number=Sing	
elvét	elv	NOUN	Case=Acc|Number=Sing|Number[psor]=Sing|Person[psor]=3	
szem	szem	NOUN	Case=Nom|Number=Sing	
előtt	előtt	ADP	_	
tartva	tartva	ADV	VerbForm=Trans	
egy	egy	DET	Definite=Ind|PronType=Art	
gazdasági	gazdasági	ADJ	Case=Nom|Degree=Pos|Number=Sing	
szereplő	szereplő	NOUN	Case=Nom|Number=Sing	
tudja	tud	VERB	Definite=Def|Mood=Ind|Number=Sing|Person=3|Tense=Pres|VerbForm=Fin|Voice=Act	
a	a	DET	Definite=Def|PronType=Art	
feladatot	feladat	NOUN	Case=Acc|Number=Sing	
leggazdaságosabban	gazdaságosabban	ADJ	Case=Ess|Degree=Pos|Number=Sing	
elvégezni	elvégez	VERB	VerbForm=Inf|Voice=Act	
,	,	PUNCT	_	
ezért	ezért	CONJ	_	
a	a	DET	Definite=Def|PronType=Art	
részekre	rész	NOUN	Case=Sub|Number=Plur	
történő	történő	ADJ	Case=Nom|Degree=Pos|Number=Sing|VerbForm=PartPres	
ajánlattétel	ajánlattétel	NOUN	Case=Nom|Number=Sing	
nem	nem	ADV	PronType=Neg	
biztosított	biztosított	ADJ	Case=Nom|Degree=Pos|Number=Sing|VerbForm=PartPast	
.	.	PUNCT	_	

