A	a	DET	Definite=Def|PronType=Art	
Budapest	Budapest	PROPN	Case=Nom|Number=Sing	
I.	1.	ADJ	Case=Nom|NumType=Ord|Number=Sing	
kerület	kerület	NOUN	Case=Nom|Number=Sing	
Budavári	Budavári	PROPN	Case=Nom|Number=Sing	
Önkormányzat	Önkormányzat	PROPN	Case=Nom|Number=Sing	
által	által	ADP	_	
működtetett	működtetett	ADJ	Case=Nom|Degree=Pos|Number=Sing|VerbForm=PartPast	
,	,	PUNCT	_	
a	a	DET	Definite=Def|PronType=Art	
Klebelsberg	klebelsberg	NOUN	Case=Nom|Number=Sing	
Intézményfenntartó	intézményfenntartó	ADJ	Case=Nom|Degree=Pos|Number=Sing|VerbForm=PartPres	
Központ	Központ	PROPN	Case=Nom|Number=Sing	
Budapest	Budapest	PROPN	Case=Nom|Number=Sing	
I.	I.	PROPN	Case=Nom|Number=Sing	

Tankerület	tankerület	NOUN	Case=Nom|Number=Sing	
által	által	ADP	_	
fenntartott	fenntartott	ADJ	Case=Nom|Degree=Pos|Number=Sing|VerbForm=PartPast	
Batthyány	Batthyány	PROPN	Case=Nom|Number=Sing	
Lajos	Lajos	PROPN	Case=Nom|Number=Sing	
Általános	Általános	PROPN	Case=Nom|Number=Sing	
Iskola	Iskola	PROPN	Case=Nom|Number=Sing	
,	,	PUNCT	_	
Budavári	Budavári	PROPN	Case=Nom|Number=Sing	
Általános	Általános	PROPN	Case=Nom|Number=Sing	
Iskola	Iskola	PROPN	Case=Nom|Number=Sing	
,	,	PUNCT	_	
Kosztolányi	Kosztolányi	PROPN	Case=Nom|Number=Sing	
Dezső	Dezső	PROPN	Case=Nom|Number=Sing	
Gimnázium	Gimnázium	PROPN	Case=Nom|Number=Sing	
,	,	PUNCT	_	
Lisznyai	lisznyai	NOUN	Case=Nom|Number=Sing	
Utcai	Utcai	PROPN	Case=Nom|Number=Sing	
Általános	Általános	PROPN	Case=Nom|Number=Sing	
Iskola	Iskola	PROPN	Case=Nom|Number=Sing	
,	,	PUNCT	_	
valamint	valamint	CONJ	_	
a	a	DET	Definite=Def|PronType=Art	
nyári	nyári	ADJ	Case=Nom|Degree=Pos|Number=Sing	
napközis	napközis	ADJ	Case=Nom|Degree=Pos|Number=Sing	
tábor	tábor	NOUN	Case=Nom|Number=Sing	
,	,	PUNCT	_	
Szilágyi	szilágyi	ADJ	Case=Nom|Degree=Pos|Number=Sing	
Erzsébet	Erzsébet	PROPN	Case=Nom|Number=Sing	
Gimnázium	Gimnázium	PROPN	Case=Nom|Number=Sing	
,	,	PUNCT	_	
Toldy	toldy	NOUN	Case=Nom|Number=Sing	
Ferenc	Ferenc	PROPN	Case=Nom|Number=Sing	
Gimnázium	Gimnázium	PROPN	Case=Nom|Number=Sing	
közétkeztetési	közétkeztetési	ADJ	Case=Nom|Degree=Pos|Number=Sing	
feladatainak	feladat	NOUN	Case=Gen|Number=Plur|Number[psor]=Sing|Person[psor]=3	
ellátása	ellátás	NOUN	Case=Nom|Number=Sing|Number[psor]=Sing|Person[psor]=3	
6	6	NUM	Case=Nom|NumType=Card|Number=Sing	
(	(	PUNCT	_	
hat	hat	NUM	Case=Nom|NumType=Card|Number=Sing	
)	)	PUNCT	_	
,	,	PUNCT	_	
önállóan	önálló	ADJ	Case=Ess|Degree=Pos|Number=Sing	
megajánlható	megajánlható	ADJ	Case=Nom|Degree=Pos|Number=Sing	
részben	rész	NOUN	Case=Ine|Number=Sing	
.	.	PUNCT	_	

Szolgáltatás	szolgáltatás	NOUN	Case=Nom|Number=Sing	
kezdő	kezdő	ADJ	Case=Nom|Degree=Pos|Number=Sing|VerbForm=PartPres	
időpontja	időpont	NOUN	Case=Nom|Number=Sing|Number[psor]=Sing|Person[psor]=3	
valamennyi	valamennyi	PRON	Case=Nom|Number=Sing|Person=3|PronType=Tot	
rész	rész	NOUN	Case=Nom|Number=Sing	
esetében	eset	NOUN	Case=Ine|Number=Sing|Number[psor]=Sing|Person[psor]=3	
:	:	PUNCT	_	
1.9.2017	1.9.2017	PROPN	Case=Nom|Number=Sing	
.	.	PUNCT	_	
,	,	PUNCT	_	
befejező	befejező	ADJ	Case=Nom|Degree=Pos|Number=Sing|VerbForm=PartPres	
időpontja	időpont	NOUN	Case=Nom|Number=Sing|Number[psor]=Sing|Person[psor]=3	
:	:	PUNCT	_	
31.8.2019	31.8.2019	PROPN	Case=Nom|Number=Sing	
.	.	PUNCT	_	

