Semmelweis	Semmelweis	PROPN	Case=Nom|Number=Sing	
Egyetem	Egyetem	PROPN	Case=Nom|Number=Sing	
Központi	Központi	PROPN	Case=Nom|Number=Sing	
Textiltisztító	textiltisztító	NOUN	Case=Nom|Number=Sing	
és	és	CONJ	_	
Javító	javító	ADJ	Case=Nom|Degree=Pos|Number=Sing	
Üzem	üzem	NOUN	Case=Nom|Number=Sing	
részére	részére	ADP	_	
chemo-thermo	chemo-thermo	NOUN	Case=Nom|Number=Sing	
dezinfekciós	dezinfekciós	ADJ	Case=Nom|Degree=Pos|Number=Sing	
mosástechnológiához	mosástechnológia	NOUN	Case=All|Number=Sing	
szükséges	szükséges	ADJ	Case=Nom|Degree=Pos|Number=Sing	
mosás-hatékony	mosás-hatékony	ADJ	Case=Nom|Degree=Pos|Number=Sing	
vegyületek	vegyület	NOUN	Case=Nom|Number=Plur	
,	,	PUNCT	_	
fertőtlenítőszerek	fertőtlenítőszer	NOUN	Case=Nom|Number=Plur	
és	és	CONJ	_	
mosószerek	mosószer	NOUN	Case=Nom|Number=Plur	
beszerzése	beszerzés	NOUN	Case=Nom|Number=Sing|Number[psor]=Sing|Person[psor]=3	
.	.	PUNCT	_	

