Az	az	DET	Definite=Def|PronType=Art	
Art	Art	PROPN	Case=Nom|Number=Sing	
Water	Water	PROPN	Case=Nom|Number=Sing	
Kft.	Kft.	PROPN	Case=Nom|Number=Sing	
vállalkozási	vállalkozási	ADJ	Case=Nom|Degree=Pos|Number=Sing	
szerződéssel	szerződés	NOUN	Case=Ins|Number=Sing	
vegyes	vegyes	ADJ	Case=Nom|Degree=Pos|Number=Sing	
adásvételi	adásvételi	ADJ	Case=Nom|Degree=Pos|Number=Sing	
szerződés	szerződés	NOUN	Case=Nom|Number=Sing	
megkötésével	megkötés	NOUN	Case=Ins|Number=Sing|Number[psor]=Sing|Person[psor]=3	
,	,	PUNCT	_	
a	a	DET	Definite=Def|PronType=Art	
„	„	PUNCT	_	
GINOP-1	GINOP-1	PROPN	Case=Nom|Number=Sing	
.	.	PUNCT	_	

2	2	NUM	Case=Nom|NumType=Card|Number=Sing	
.	.	PUNCT	_	
1-15	1-15	NUM	Case=Nom|NumType=Card|Number=Sing	
-	-	PUNCT	_	
GINOP	GINOP	PROPN	Case=Nom|Number=Sing	
-	-	PUNCT	_	
Mikro	Mikro	PROPN	Case=Nom|Number=Sing	
,	,	PUNCT	_	
kis-és	kis-és	CONJ	_	
középvállalkozások	középvállalkozás	NOUN	Case=Nom|Number=Plur	
termelési	termelési	ADJ	Case=Nom|Degree=Pos|Number=Sing	
kapacitásainak	kapacitás	NOUN	Case=Gen|Number=Plur|Number[psor]=Sing|Person[psor]=3	
bővítése	bővítés	NOUN	Case=Nom|Number=Sing|Number[psor]=Sing|Person[psor]=3	
,	,	PUNCT	_	
Hibrid	hibrid	ADJ	Case=Nom|Degree=Pos|Number=Sing	
gyártósor	gyártósor	NOUN	Case=Nom|Number=Sing	
fejlesztés	fejlesztés	NOUN	Case=Nom|Number=Sing	
az	az	DET	Definite=Def|PronType=Art	
Art	Art	PROPN	Case=Nom|Number=Sing	
Water	Water	PROPN	Case=Nom|Number=Sing	
Kft.	Kft.	PROPN	Case=Nom|Number=Sing	

-	-	PUNCT	_	
nél	Rt.	PROPN	Case=Ade|Number=Sing	
"	"	PUNCT	_	
című	című	ADJ	Case=Nom|Degree=Pos|Number=Sing	
támogatott	támogatott	ADJ	Case=Nom|Degree=Pos|Number=Sing|VerbForm=PartPast	
projekthez	projekt	NOUN	Case=All|Number=Sing	
kapcsolódó	kapcsolódó	ADJ	Case=Nom|Degree=Pos|Number=Sing|VerbForm=PartPres	
árubeszerzés	árubeszerzés	NOUN	Case=Nom|Number=Sing	
keretében	keret	NOUN	Case=Ine|Number=Sing|Number[psor]=Sing|Person[psor]=3	
komplett	komplett	ADJ	Case=Nom|Degree=Pos|Number=Sing	
ásványvíz	ásványvíz	NOUN	Case=Nom|Number=Sing	
és	és	CONJ	_	
üdítőital	üdítőital	NOUN	Case=Nom|Number=Sing	
gyártó	gyártó	NOUN	Case=Nom|Number=Sing	
technológiát	technológia	NOUN	Case=Acc|Number=Sing	
kíván	kíván	VERB	Definite=Ind|Mood=Ind|Number=Sing|Person=3|Tense=Pres|VerbForm=Fin|Voice=Act	
beszerezni	beszerez	VERB	VerbForm=Inf|Voice=Act	
.	.	PUNCT	_	

A	a	DET	Definite=Def|PronType=Art	
komplett	komplett	ADJ	Case=Nom|Degree=Pos|Number=Sing	
technológia	technológia	NOUN	Case=Nom|Number=Sing	
eredményeképp	eredmény	NOUN	Case=Abs|Number=Sing|Number[psor]=Sing|Person[psor]=3	
széndioxiddal	széndioxid	NOUN	Case=Ins|Number=Sing	
dúsított	dúsított	ADJ	Case=Nom|Degree=Pos|Number=Sing|VerbForm=PartPast	
ásványvíz	ásványvíz	NOUN	Case=Nom|Number=Sing	
és	és	CONJ	_	
szénsavmentes	szénsavmentes	ADJ	Case=Nom|Degree=Pos|Number=Sing	
ásványvíz	ásványvíz	NOUN	Case=Nom|Number=Sing	
,	,	PUNCT	_	
szénsavas	szénsavas	ADJ	Case=Nom|Degree=Pos|Number=Sing	
és	és	CONJ	_	
szénsavmentes	szénsavmentes	ADJ	Case=Nom|Degree=Pos|Number=Sing	
üdítőital	üdítőital	NOUN	Case=Nom|Number=Sing	
palackozható	palackozható	ADJ	Case=Nom|Degree=Pos|Number=Sing	
.	.	PUNCT	_	

