Szállítási	Szállítási	PROPN	Case=Nom|Number=Sing	
keretszerződés	keretszerződés	NOUN	Case=Nom|Number=Sing	
/	/	PUNCT	_	
Tisztítószerek	tisztítószer	NOUN	Case=Nom|Number=Plur	
és	és	CONJ	_	
higiéniás	higiéniás	ADJ	Case=Nom|Degree=Pos|Number=Sing	
szerek	szer	NOUN	Case=Nom|Number=Plur	
beszerzése	beszerzés	NOUN	Case=Nom|Number=Sing|Number[psor]=Sing|Person[psor]=3	
a	a	DET	Definite=Def|PronType=Art	
Budapest	Budapest	PROPN	Case=Nom|Number=Sing	
Főváros	főváros	NOUN	Case=Nom|Number=Sing	
XIV	14	NUM	Case=Nom|NumType=Card|Number=Sing	
Kerület	Kerület	PROPN	Case=Nom|Number=Sing	
Zugló	zugló	NOUN	Case=Nom|Number=Sing	
Önkormányzata	Önkormányzata	PROPN	Case=Nom|Number=Sing	
fenntartásában	fenntartás	NOUN	Case=Ine|Number=Sing|Number[psor]=Sing|Person[psor]=3	
működő	működő	ADJ	Case=Nom|Degree=Pos|Number=Sing|VerbForm=PartPres	
intézmények	intézmény	NOUN	Case=Nom|Number=Plur	
részére	részére	ADP	_	
.	.	PUNCT	_	

