Megbízási	megbízási	ADJ	Case=Nom|Degree=Pos|Number=Sing	
szerződés	szerződés	NOUN	Case=Nom|Number=Sing	
a	a	DET	Definite=Def|PronType=Art	
Bajai	bajai	ADJ	Case=Nom|Degree=Pos|Number=Sing	
agglomerációhoz	agglomeráció	NOUN	Case=All|Number=Sing	
tartozó	tartozó	ADJ	Case=Nom|Degree=Pos|Number=Sing|VerbForm=PartPres	
települések	település	NOUN	Case=Nom|Number=Plur	
szennyvízcsatornázása	szennyvízcsatornázás	NOUN	Case=Nom|Number=Sing|Number[psor]=Sing|Person[psor]=3	
és	és	CONJ	_	
szennyvíztisztítása	szennyvíztisztítás	NOUN	Case=Nom|Number=Sing|Number[psor]=Sing|Person[psor]=3	
KEOP-1	KEOP-1	PROPN	Case=Nom|Number=Sing	
.	.	PUNCT	_	

2.0	2.0	PROPN	Case=Nom|Number=Sing	
/	/	PUNCT	_	
2F	2F	NUM	Case=Nom|NumType=Card|Number=Sing	
/	/	PUNCT	_	
09-2010-0078	09-2010-0078	PROPN	Case=Nom|Number=Sing	
számú	számú	ADJ	Case=Nom|Degree=Pos|Number=Sing	
projekt	projekt	NOUN	Case=Nom|Number=Sing	
megvalósításához	megvalósítás	NOUN	Case=All|Number=Sing|Number[psor]=Sing|Person[psor]=3	
szükséges	szükséges	ADJ	Case=Nom|Degree=Pos|Number=Sing	
FIDIC	FIDIC	PROPN	Case=Nom|Number=Sing	
mérnöki	mérnöki	ADJ	Case=Nom|Degree=Pos|Number=Sing	
és	és	CONJ	_	
műszaki	műszaki	ADJ	Case=Nom|Degree=Pos|Number=Sing	
ellenőri	ellenőri	ADJ	Case=Nom|Degree=Pos|Number=Sing	
tevékenység	tevékenység	NOUN	Case=Nom|Number=Sing	
ellátására	ellátás	NOUN	Case=Sub|Number=Sing|Number[psor]=Sing|Person[psor]=3	
.	.	PUNCT	_	

