Tárgya	tárgy	NOUN	Case=Nom|Number=Sing|Number[psor]=Sing|Person[psor]=3	
:	:	PUNCT	_	
vállalkozási	vállalkozási	ADJ	Case=Nom|Degree=Pos|Number=Sing	
szerződés	szerződés	NOUN	Case=Nom|Number=Sing	
„	„	PUNCT	_	
Egyedi	egyedi	ADJ	Case=Nom|Degree=Pos|Number=Sing	
gyártású	gyártású	ADJ	Case=Nom|Degree=Pos|Number=Sing	
vegyipari	vegyipari	ADJ	Case=Nom|Degree=Pos|Number=Sing	
reaktor	reaktor	NOUN	Case=Nom|Number=Sing	
modul	modul	NOUN	Case=Nom|Number=Sing	
,	,	PUNCT	_	
valamint	valamint	CONJ	_	
a	a	DET	Definite=Def|PronType=Art	
hozzá	ő	PRON	Case=All|Number=Sing|Person=3|PronType=Prs	
műszakilag	műszaki	ADJ	Case=Ess|Degree=Pos|Number=Sing	
és	és	CONJ	_	
technológiailag	technológiailag	ADV	_	
kapcsolódó	kapcsolódó	ADJ	Case=Nom|Degree=Pos|Number=Sing|VerbForm=PartPres	
1	1	NUM	Case=Nom|NumType=Card|Number=Sing	
db	db	NOUN	Case=Nom|Number=Sing	
gáz	gáz	NOUN	Case=Nom|Number=Sing	
elszívó	elszívó	ADJ	Case=Nom|Degree=Pos|Number=Sing|VerbForm=PartPres	
és	és	CONJ	_	
gázmosó	gázmosó	ADJ	Case=Nom|Degree=Pos|Number=Sing	
berendezés	berendezés	NOUN	Case=Nom|Number=Sing	
beszerzése	beszerzés	NOUN	Case=Nom|Number=Sing|Number[psor]=Sing|Person[psor]=3	
"	"	PUNCT	_	
tárgyban	tárgy	NOUN	Case=Ine|Number=Sing	
HU09-0074-A2-2013	HU09-0074-A2-2013	PROPN	Case=Nom|Number=Sing	
azonosító	azonosító	ADJ	Case=Nom|Degree=Pos|Number=Sing|VerbForm=PartPres	
számú	számú	ADJ	Case=Nom|Degree=Pos|Number=Sing	
„	„	PUNCT	_	
2009-2014	2009-2014	NUM	Case=Nom|NumType=Card|Number=Sing	
Norvég	norvég	NOUN	Case=Nom|Number=Sing	
Finanszírozási	finanszírozási	ADJ	Case=Nom|Degree=Pos|Number=Sing	
mechanizmus	mechanizmus	NOUN	Case=Nom|Number=Sing	
Zöld	zöld	ADJ	Case=Nom|Degree=Pos|Number=Sing	
ipari	ipari	ADJ	Case=Nom|Degree=Pos|Number=Sing	
innovációs	innovációs	ADJ	Case=Nom|Degree=Pos|Number=Sing	
program	program	NOUN	Case=Nom|Number=Sing	
-	-	PUNCT	_	
Környezetbarát	környezetbarát	ADJ	Case=Nom|Degree=Pos|Number=Sing	
termelési	termelési	ADJ	Case=Nom|Degree=Pos|Number=Sing	
technológiák	technológia	NOUN	Case=Nom|Number=Plur	
fokozottabb	fokozott	ADJ	Case=Nom|Degree=Cmp|Number=Sing	
használata	használat	NOUN	Case=Nom|Number=Sing|Number[psor]=Sing|Person[psor]=3	
"	"	PUNCT	_	
alprogram	alprogram	NOUN	Case=Nom|Number=Sing	
keretében	keret	NOUN	Case=Ine|Number=Sing|Number[psor]=Sing|Person[psor]=3	
„	„	PUNCT	_	
Víz	víz	NOUN	Case=Nom|Number=Sing	
-	-	PUNCT	_	
és	és	CONJ	_	
szennyvízkezelési	szennyvízkezelési	ADJ	Case=Nom|Degree=Pos|Number=Sing	
vegyszerek	vegyszer	NOUN	Case=Nom|Number=Plur	
gyártása	gyártás	NOUN	Case=Nom|Number=Sing|Number[psor]=Sing|Person[psor]=3	
során	sor	NOUN	Case=Sup|Number=Sing|Number[psor]=Sing|Person[psor]=3	
keletkező	keletkező	ADJ	Case=Nom|Degree=Pos|Number=Sing|VerbForm=PartPres	
vesz	vesz	VERB	Definite=Ind|Mood=Ind|Number=Sing|Person=3|Tense=Pres|VerbForm=Fin|Voice=Act	
.	.	PUNCT	_	
hull	hull	VERB	Definite=Ind|Mood=Ind|Number=Sing|Person=3|Tense=Pres|VerbForm=Fin|Voice=Act	
.	.	PUNCT	_	
és	és	CONJ	_	
energiaigény	energiaigény	NOUN	Case=Nom|Number=Sing	
csökkentése	csökkentés	NOUN	Case=Nom|Number=Sing|Number[psor]=Sing|Person[psor]=3	
a	a	DET	Definite=Def|PronType=Art	
reaktortér	reaktortér	NOUN	Case=Nom|Number=Sing	
és	és	CONJ	_	
szűréstechnológia	szűréstechnológia	NOUN	Case=Nom|Number=Sing	
fejlesztésével	fejlesztés	NOUN	Case=Ins|Number=Sing|Number[psor]=Sing|Person[psor]=3	
"	"	PUNCT	_	
projekt	projekt	NOUN	Case=Nom|Number=Sing	
keretében	keret	NOUN	Case=Ine|Number=Sing|Number[psor]=Sing|Person[psor]=3	
4db	4db	NUM	Case=Nom|NumType=Card|Number=Sing	
vegyipari	vegyipari	ADJ	Case=Nom|Degree=Pos|Number=Sing	
reaktor	reaktor	NOUN	Case=Nom|Number=Sing	
modulnak	modul	NOUN	Case=Dat|Number=Sing	
,	,	PUNCT	_	
valamint	valamint	CONJ	_	
a	a	DET	Definite=Def|PronType=Art	
hozzá	ő	PRON	Case=All|Number=Sing|Person=3|PronType=Prs	
műszakilag	műszaki	ADJ	Case=Ess|Degree=Pos|Number=Sing	
és	és	CONJ	_	
technológiailag	technológiailag	ADV	_	
kapcsolódó	kapcsolódó	ADJ	Case=Nom|Degree=Pos|Number=Sing|VerbForm=PartPres	
1	1	NUM	Case=Nom|NumType=Card|Number=Sing	
db	db	NOUN	Case=Nom|Number=Sing	
gáz	gáz	NOUN	Case=Nom|Number=Sing	
elszívó	elszívó	ADJ	Case=Nom|Degree=Pos|Number=Sing|VerbForm=PartPres	
és	és	CONJ	_	
gázmosó	gázmosó	NOUN	Case=Nom|Number=Sing	
berendezésnek	berendezés	NOUN	Case=Dat|Number=Sing	
a	a	DET	Definite=Def|PronType=Art	
Műszaki	Műszaki	PROPN	Case=Nom|Number=Sing	
leírásban	leírás	NOUN	Case=Ine|Number=Sing	
meghatározott	meghatározott	ADJ	Case=Nom|Degree=Pos|Number=Sing|VerbForm=PartPast	
paraméterek	paraméter	NOUN	Case=Nom|Number=Plur	
és	és	CONJ	_	
tervek	terv	NOUN	Case=Nom|Number=Plur	
szerinti	szerinti	ADJ	Case=Nom|Degree=Pos|Number=Sing	
legyártása	legyártás	NOUN	Case=Nom|Number=Sing|Number[psor]=Sing|Person[psor]=3	
,	,	PUNCT	_	
leszállítása	leszállítás	NOUN	Case=Nom|Number=Sing|Number[psor]=Sing|Person[psor]=3	
,	,	PUNCT	_	
telepítése	telepítés	NOUN	Case=Nom|Number=Sing|Number[psor]=Sing|Person[psor]=3	
és	és	CONJ	_	
beüzemelése	beüzemelés	NOUN	Case=Nom|Number=Sing|Number[psor]=Sing|Person[psor]=3	
Ajánlatkérő	ajánlatkérő	NOUN	Case=Nom|Number=Sing	
székhelyén	székhely	NOUN	Case=Sup|Number=Sing|Number[psor]=Sing|Person[psor]=3	
.	.	PUNCT	_	

