Kivitelezési	kivitelezési	ADJ	Case=Nom|Degree=Pos|Number=Sing	
közbeszerzés	közbeszerzés	NOUN	Case=Nom|Number=Sing	
eljárás	eljárás	NOUN	Case=Nom|Number=Sing	
lefolytatása	lefolytatás	NOUN	Case=Nom|Number=Sing|Number[psor]=Sing|Person[psor]=3	
az	az	DET	Definite=Def|PronType=Art	
ÁEEK	ÁEEK	NOUN	Case=Nom|Number=Plur	
Projektirányítási	projektirányítási	ADJ	Case=Nom|Degree=Pos|Number=Sing	
Igazgatóság	igazgatóság	NOUN	Case=Nom|Number=Sing	
által	által	ADP	_	
megvalósítandó	megvalósítandó	ADJ	Case=Nom|Degree=Pos|Number=Sing|VerbForm=PartFut	
kelet-magyarországi	kelet-magyarországi	ADJ	Case=Nom|Degree=Pos|Number=Sing	
_	_	X	_	
1	1	NUM	Case=Nom|NumType=Card|Number=Sing	
kivitelezési	kivitelezési	ADJ	Case=Nom|Degree=Pos|Number=Sing	
eljárások	eljárás	NOUN	Case=Nom|Number=Plur	
tekintetében	tekintet	NOUN	Case=Ine|Number=Sing|Number[psor]=Sing|Person[psor]=3	
-	-	PUNCT	_	
6	6	NUM	Case=Nom|NumType=Card|Number=Sing	
részben	rész	NOUN	Case=Ine|Number=Sing	
VI	6	NUM	Case=Nom|NumType=Card|Number=Sing	
.	.	PUNCT	_	

4.3	4.3	PROPN	Case=Nom|Number=Sing	
)	)	PUNCT	_	
folyt	folyik	VERB	Definite=Ind|Mood=Ind|Number=Sing|Person=3|Tense=Past|VerbForm=Fin|Voice=Act	
.	.	PUNCT	_	

25.	25.	ADJ	Case=Nom|NumType=Ord|Number=Sing	

Ajánlatkérő	ajánlatkérő	NOUN	Case=Nom|Number=Sing	
a	a	DET	Definite=Def|PronType=Art	
Kbt.	Kbt.	PROPN	Case=Nom|Number=Sing	
104.	104.	ADJ	Case=Nom|NumType=Ord|Number=Sing	
§	§	NOUN	Case=Nom|Number=Sing	
(	(	PUNCT	_	
7	7	NUM	Case=Nom|NumType=Card|Number=Sing	
)	)	PUNCT	_	
bek.	bek.	NOUN	Case=Nom|Number=Sing	
alapján	alap	NOUN	Case=Sup|Number=Sing|Number[psor]=Sing|Person[psor]=3	
felhívja	felhív	VERB	Definite=Def|Mood=Ind|Number=Sing|Person=3|Tense=Pres|VerbForm=Fin|Voice=Act	
a	a	DET	Definite=Def|PronType=Art	
figyelmet	figyelem	NOUN	Case=Acc|Number=Sing	
,	,	PUNCT	_	
hogy	hogy	SCONJ	_	
tárgyi	tárgyi	ADJ	Case=Nom|Degree=Pos|Number=Sing	
beszerzés	beszerzés	NOUN	Case=Nom|Number=Sing	
vonatkozásában	vonatkozás	NOUN	Case=Ine|Number=Sing|Number[psor]=Sing|Person[psor]=3	
korábban	korán	ADV	Degree=Cmp	
keretmegállapodást	keretmegállapodás	NOUN	Case=Acc|Number=Sing	
kötött	köt	VERB	Definite=Ind|Mood=Ind|Number=Sing|Person=3|Tense=Past|VerbForm=Fin|Voice=Act	
.	.	PUNCT	_	

Ajánlatkérőnek	ajánlatkérő	NOUN	Case=Dat|Number=Sing	
az	az	DET	Definite=Def|PronType=Art	
új	új	ADJ	Case=Nom|Degree=Pos|Number=Sing	
eljárást	eljárás	NOUN	Case=Acc|Number=Sing	
megindító	megindító	ADJ	Case=Nom|Degree=Pos|Number=Sing|VerbForm=PartPres	
felhívásban	felhívás	NOUN	Case=Ine|Number=Sing	
utalnia	utal	VERB	Number=Sing|Person=3|Tense=Pres|VerbForm=Inf|Voice=Act	
kell	kell	VERB	Definite=Ind|Mood=Ind|Number=Sing|Person=3|Tense=Pres|VerbForm=Fin|Voice=Act	
arra	az	PRON	Case=Sub|Number=Sing|Person=3|PronType=Dem	
a	a	DET	Definite=Def|PronType=Art	
körülményre	körülmény	NOUN	Case=Sub|Number=Sing	
,	,	PUNCT	_	
hogy	hogy	SCONJ	_	
ugyanazon	ugyanazon	PRON	Case=Nom|Number=Sing|Person=3|PronType=Dem	
tárgyban	tárgy	NOUN	Case=Ine|Number=Sing	
már	már	ADV	_	
egy	egy	DET	Definite=Ind|PronType=Art	
keretmegállapodás	keretmegállapodás	NOUN	Case=Nom|Number=Sing	
is	is	CONJ	_	
megkötésre	megkötés	NOUN	Case=Sub|Number=Sing	
került	kerül	VERB	Definite=Ind|Mood=Ind|Number=Sing|Person=3|Tense=Past|VerbForm=Fin|Voice=Act	
,	,	PUNCT	_	
amelynek	amely	PRON	Case=Gen|Number=Sing|Person=3|PronType=Rel	
Ajánlatkérő	ajánlatkérő	NOUN	Case=Nom|Number=Sing	
ezúton	ezúton	ADV	PronType=Dem	
tesz	tesz	VERB	Definite=Ind|Mood=Ind|Number=Sing|Person=3|Tense=Pres|VerbForm=Fin|Voice=Act	
eleget	elég	NOUN	Case=Acc|Number=Sing	
,	,	PUNCT	_	
valamint	valamint	CONJ	_	
hatályos	hatályos	ADJ	Case=Nom|Degree=Pos|Number=Sing	
keretmegállapodás	keretmegállapodás	NOUN	Case=Nom|Number=Sing	
esetén	eset	NOUN	Case=Sup|Number=Sing|Number[psor]=Sing|Person[psor]=3	
,	,	PUNCT	_	
az	az	DET	Definite=Def|PronType=Art	
újonnan	újonnan	ADV	Degree=Pos	
induló	induló	ADJ	Case=Nom|Degree=Pos|Number=Sing|VerbForm=PartPres	
eljárás	eljárás	NOUN	Case=Nom|Number=Sing	
hirdetményének	hirdetmény	NOUN	Case=Gen|Number=Sing|Number[psor]=Sing|Person[psor]=3	
közzétételéről	közzététel	NOUN	Case=Del|Number=Sing|Number[psor]=Sing|Person[psor]=3	
az	az	DET	Definite=Def|PronType=Art	
ajánlatkérőnek	ajánlatkérő	NOUN	Case=Dat|Number=Sing	
haladéktalanul	haladéktalan	ADJ	Case=Ess|Degree=Pos|Number=Sing	
értesítenie	értesítenie	VERB	Number=Sing|Person=3|VerbForm=Inf|Voice=Act	
kell	kell	VERB	Definite=Ind|Mood=Ind|Number=Sing|Person=3|Tense=Pres|VerbForm=Fin|Voice=Act	
a	a	DET	Definite=Def|PronType=Art	
keretmegállapodást	keretmegállapodás	NOUN	Case=Acc|Number=Sing	
kötött	köt	VERB	Definite=Ind|Mood=Ind|Number=Sing|Person=3|Tense=Past|VerbForm=Fin|Voice=Act	
ajánlattevőket	ajánlattevő	NOUN	Case=Acc|Number=Plur	
,	,	PUNCT	_	
amely	amely	PRON	Case=Nom|Number=Sing|Person=3|PronType=Rel	
előírásnak	előírás	NOUN	Case=Gen|Number=Sing	
Ajánlatkérő	ajánlatkérő	NOUN	Case=Nom|Number=Sing	
szintén	szintén	CONJ	_	
eleget	elég	NOUN	Case=Acc|Number=Sing	
tesz	tesz	VERB	Definite=Ind|Mood=Ind|Number=Sing|Person=3|Tense=Pres|VerbForm=Fin|Voice=Act	
.	.	PUNCT	_	

