Tervezési	tervezési	ADJ	Case=Nom|Degree=Pos|Number=Sing	
szerződés	szerződés	NOUN	Case=Nom|Number=Sing	
.	.	PUNCT	_	

Egyesített	egyesített	ADJ	Case=Nom|Degree=Pos|Number=Sing|VerbForm=PartPast	
engedélyezési	engedélyezési	ADJ	Case=Nom|Degree=Pos|Number=Sing	
és	és	CONJ	_	
kiviteli	kiviteli	ADJ	Case=Nom|Degree=Pos|Number=Sing	
tervdokumentáció	tervdokumentáció	NOUN	Case=Nom|Number=Sing	
készítése	készítés	NOUN	Case=Nom|Number=Sing|Number[psor]=Sing|Person[psor]=3	
és	és	CONJ	_	
jogerős	jogerős	ADJ	Case=Nom|Degree=Pos|Number=Sing	
építési	építési	ADJ	Case=Nom|Degree=Pos|Number=Sing	
engedély	engedély	NOUN	Case=Nom|Number=Sing	
megszerzése	megszerzés	NOUN	Case=Nom|Number=Sing|Number[psor]=Sing|Person[psor]=3	
a	a	DET	Definite=Def|PronType=Art	
TEN-T	TEN	NOUN	Case=Acc|Number=Sing	
közúti	közúti	ADJ	Case=Nom|Degree=Pos|Number=Sing	
hálózat	hálózat	NOUN	Case=Nom|Number=Sing	
elemein	elem	NOUN	Case=Sup|Number=Plur|Number[psor]=Sing|Person[psor]=3	
a	a	DET	Definite=Def|PronType=Art	
zajszennyezés	zajszennyezés	NOUN	Case=Nom|Number=Sing	
csökkentését	csökkentés	NOUN	Case=Acc|Number=Sing|Number[psor]=Sing|Person[psor]=3	
célzó	célzó	ADJ	Case=Nom|Degree=Pos|Number=Sing|VerbForm=PartPres	
,	,	PUNCT	_	
a	a	DET	Definite=Def|PronType=Art	
zajárnyékoló	zajárnyékoló	ADJ	Case=Nom|Degree=Pos|Number=Sing	
létesítmények	létesítmény	NOUN	Case=Nom|Number=Plur	
fejlesztési	fejlesztési	ADJ	Case=Nom|Degree=Pos|Number=Sing	
beruházásaihoz	beruházás	NOUN	Case=All|Number=Plur|Number[psor]=Sing|Person[psor]=3	
a	a	DET	Definite=Def|PronType=Art	
Megrendelő	megrendelő	NOUN	Case=Nom|Number=Sing	
kezelésében	kezelés	NOUN	Case=Ine|Number=Sing|Number[psor]=Sing|Person[psor]=3	
lévő	lévő	ADJ	Case=Nom|Degree=Pos|Number=Sing|VerbForm=PartPres	
útszakaszokon	útszakasz	NOUN	Case=Sup|Number=Plur	
,	,	PUNCT	_	
4	4	NUM	Case=Nom|NumType=Card|Number=Sing	
rész	rész	NOUN	Case=Nom|Number=Sing	
vonatkozásában	vonatkozás	NOUN	Case=Ine|Number=Sing|Number[psor]=Sing|Person[psor]=3	
,	,	PUNCT	_	
tervezési	tervezési	ADJ	Case=Nom|Degree=Pos|Number=Sing	
szerződés	szerződés	NOUN	Case=Nom|Number=Sing	
alapján	alap	NOUN	Case=Sup|Number=Sing|Number[psor]=Sing|Person[psor]=3	
.	.	PUNCT	_	

Az	az	DET	Definite=Def|PronType=Art	
elvégzendő	elvégzendő	ADJ	Case=Nom|Degree=Pos|Number=Sing|VerbForm=PartFut	
feladatok	feladat	NOUN	Case=Nom|Number=Plur	
részletes	részletes	ADJ	Case=Nom|Degree=Pos|Number=Sing	
kifejtését	kifejtés	NOUN	Case=Acc|Number=Sing|Number[psor]=Sing|Person[psor]=3	
az	az	DET	Definite=Def|PronType=Art	
Ajánlati	ajánlati	ADJ	Case=Nom|Degree=Pos|Number=Sing	
dokumentáció	dokumentáció	NOUN	Case=Nom|Number=Sing	
III	III	PROPN	Case=Nom|Number=Sing	
.	.	PUNCT	_	

Fejezete	fejezet	NOUN	Case=Nom|Number=Sing|Number[psor]=Sing|Person[psor]=3	
(	(	PUNCT	_	
Közbeszerzési	Közbeszerzési	PROPN	Case=Nom|Number=Sing	
műszaki	műszaki	ADJ	Case=Nom|Degree=Pos|Number=Sing	
leírás	leírás	NOUN	Case=Nom|Number=Sing	
)	)	PUNCT	_	
tartalmazza	tartalmaz	VERB	Definite=Def|Mood=Ind|Number=Sing|Person=3|Tense=Pres|VerbForm=Fin|Voice=Act	
.	.	PUNCT	_	

