Tervezési	tervezési	ADJ	Case=Nom|Degree=Pos|Number=Sing	
keretmegállapodás	keretmegállapodás	NOUN	Case=Nom|Number=Sing	
a	a	DET	Definite=Def|PronType=Art	
Nemzeti	Nemzeti	PROPN	Case=Nom|Number=Sing	
Ménesbirtok	ménesbirt	NOUN	Case=Nom|Number=Plur	
és	és	CONJ	_	
Tangazdaság	Tangazdaság	PROPN	Case=Nom|Number=Sing	
Zrt.	Zrt.	PROPN	Case=Nom|Number=Sing	
részére	részére	ADP	_	
Részekre	rész	NOUN	Case=Sub|Number=Plur	
történő	történő	ADJ	Case=Nom|Degree=Pos|Number=Sing|VerbForm=PartPres	
ajánlattétel	ajánlattétel	NOUN	Case=Nom|Number=Sing	
kizárása	kizárás	NOUN	Case=Nom|Number=Sing|Number[psor]=Sing|Person[psor]=3	
:	:	PUNCT	_	
A	a	DET	Definite=Def|PronType=Art	
beszerzés	beszerzés	NOUN	Case=Nom|Number=Sing	
tárgyának	tárgy	NOUN	Case=Gen|Number=Sing|Number[psor]=Sing|Person[psor]=3	
jellege	jelleg	NOUN	Case=Nom|Number=Sing|Number[psor]=Sing|Person[psor]=3	
nem	nem	ADV	PronType=Neg	
teszi	tesz	VERB	Definite=Def|Mood=Ind|Number=Sing|Person=3|Tense=Pres|VerbForm=Fin|Voice=Act	
lehetővé	lehető	ADJ	Case=Tra|Degree=Pos|Number=Sing|VerbForm=PartPres	
a	a	DET	Definite=Def|PronType=Art	
részajánlattétel	részajánlattétel	NOUN	Case=Nom|Number=Sing	
lehetőségét	lehetőség	NOUN	Case=Acc|Number=Sing|Number[psor]=Sing|Person[psor]=3	
,	,	PUNCT	_	
figyelemmel	figyelem	NOUN	Case=Ins|Number=Sing	
arra	az	PRON	Case=Sub|Number=Sing|Person=3|PronType=Dem	
,	,	PUNCT	_	
hogy	hogy	SCONJ	_	
Ajánlatkérőnek	ajánlatkérő	NOUN	Case=Gen|Number=Sing	
különösen	különösen	ADV	Degree=Pos	
fontos	fontos	ADJ	Case=Nom|Degree=Pos|Number=Sing	
érdeke	érdek	NOUN	Case=Nom|Number=Sing|Number[psor]=Sing|Person[psor]=3	
fűződik	fűződik	VERB	Definite=Ind|Mood=Ind|Number=Sing|Person=3|Tense=Pres|VerbForm=Fin|Voice=Act	
az	az	DET	Definite=Def|PronType=Art	
egységes	egységes	ADJ	Case=Nom|Degree=Pos|Number=Sing	
feladatellátáshoz	feladatellátás	NOUN	Case=All|Number=Sing	
és	és	CONJ	_	
az	az	DET	Definite=Def|PronType=Art	
irányítási	irányítási	ADJ	Case=Nom|Degree=Pos|Number=Sing	
rendszer	rendszer	NOUN	Case=Nom|Number=Sing	
egységéhez	egység	NOUN	Case=All|Number=Sing|Number[psor]=Sing|Person[psor]=3	
valamennyi	valamennyi	PRON	Case=Nom|Number=Sing|Person=3|PronType=Tot	
szolgáltatási	szolgáltatási	ADJ	Case=Nom|Degree=Pos|Number=Sing	
területen	terület	NOUN	Case=Sup|Number=Sing	
.	.	PUNCT	_	

