Esztergom	Esztergom	PROPN	Case=Nom|Number=Sing	
Város	Város	PROPN	Case=Nom|Number=Sing	
Önkormányzatának	önkormányzat	NOUN	Case=Gen|Number=Sing|Number[psor]=Sing|Person[psor]=3	
tulajdonában	tulajdon	NOUN	Case=Ine|Number=Sing|Number[psor]=Sing|Person[psor]=3	
lévő	lévő	ADJ	Case=Nom|Degree=Pos|Number=Sing|VerbForm=PartPres	
ingatlanok	ingatlan	NOUN	Case=Nom|Number=Plur	
őrzési	őrzési	ADJ	Case=Nom|Degree=Pos|Number=Sing	
tevékenységének	tevékenység	NOUN	Case=Gen|Number=Sing|Number[psor]=Sing|Person[psor]=3	
ellátása	ellátás	NOUN	Case=Nom|Number=Sing|Number[psor]=Sing|Person[psor]=3	
szolgáltatási	szolgáltatási	ADJ	Case=Nom|Degree=Pos|Number=Sing	
szerződés	szerződés	NOUN	Case=Nom|Number=Sing	
keretében	keret	NOUN	Case=Ine|Number=Sing|Number[psor]=Sing|Person[psor]=3	
a	a	DET	Definite=Def|PronType=Art	
szerződés	szerződés	NOUN	Case=Nom|Number=Sing	
aláírásától	aláírás	NOUN	Case=Abl|Number=Sing|Number[psor]=Sing|Person[psor]=3	
számított	számított	ADJ	Case=Nom|Degree=Pos|Number=Sing|VerbForm=PartPast	
36	36	NUM	Case=Nom|NumType=Card|Number=Sing	
hónap	hónap	NOUN	Case=Nom|Number=Sing	
időtartamra	időtartam	NOUN	Case=Sub|Number=Sing	
.	.	PUNCT	_	

